a	ɑ
aa	ɑ ɑ
aár	ɑ ɑ ɹ
aáŋî	ɑ ɑ ŋ i
adam	ɑ d ɑ m
aíjɔ́	ɑ i j ɒ
aj	ɑ j
akàrt̪ìnídí	ɑ k ɑ ɹ t i n i d i
alɛ̀	ɑ l ɛ
amàðìt̪ɔ̀	ɑ m ɑ ð i t ɒ
ano	ɑ n ow
apri	ɑ p ɹ i
apriná	ɑ p ɹ i n ɑ
ari	ɑ ɹ i
arəmná	ɑ ɹ ə m n ɑ
aù	ɑ ʉ
avan	ɑ v ɑ n
avəlɛða	ɑ v ə l ɛ ð ɑ
aðáprá	ɑ ð ɑ p ɹ ɑ
aŋa	ɑ ŋ ɑ
aŋìðìní	ɑ ŋ i ð i n i
aɽəŋajt̪i	ɑ ɹ ə ŋ ɑ j t i
aɽəŋajt̪o	ɑ ɹ ə ŋ ɑ j t ow
aɽəŋajt̪ɜlo	ɑ ɹ ə ŋ ɑ j t ɐ l ow
aɽəŋat̪ɜlo	ɑ ɹ ə ŋ ɑ t ɐ l ow
à	ɑ
àbrá	ɑ b ɹ ɑ
àbrt̪á	ɑ b ɹ t ɑ
àbrú	ɑ b ɹ ʉ
àbùt̪á	ɑ b ʉ t ɑ
àbùðàt̪á	ɑ b ʉ ð ɑ t ɑ
àbùðá	ɑ b ʉ ð ɑ
àbðôl	ɑ b ð ow l
àbðɔ́	ɑ b ð ɒ
àdàm	ɑ d ɑ m
àdám	ɑ d ɑ m
àdámà	ɑ d ɑ m ɑ
àdámá	ɑ d ɑ m ɑ
àdɔ̀ŋnɔ̀	ɑ d ɒ ŋ n ɒ
àdɔ̀ŋnɔ́	ɑ d ɒ ŋ n ɒ
àdɔ̀ŋnɛ̀	ɑ d ɒ ŋ n ɛ
àdɔ́ŋðà	ɑ d ɒ ŋ ð ɑ
àdə̀ɽɔ̀l	ɑ d ə ɹ ɒ l
àd̪úɾì	ɑ d ʉ ɾ i
àd̪úɾǐ	ɑ d ʉ ɾ i
àìt̪íŋì	ɑ i t i ŋ i
àít̪éɲáré	ɑ i t ɛ ɲ ɑ ɹ ɛ
àít̪ɔ́	ɑ i t ɒ
àjá	ɑ j ɑ
àjènɛ̀	ɑ j ɛ n ɛ
àjènɛ́	ɑ j ɛ n ɛ
àjén	ɑ j ɛ n
àjìnɛ̀	ɑ j i n ɛ
àjín	ɑ j i n
àjóŋò	ɑ j ow ŋ ow
àjóŋərɛ̀	ɑ j ow ŋ ə ɹ ɛ
àjɛ̀n	ɑ j ɛ n
àjɛ́n	ɑ j ɛ n
àjɛ̌n	ɑ j ɛ n
àkáɽə̀ŋàt̪à	ɑ k ɑ ɹ ə ŋ ɑ t ɑ
àkáɽə̀ŋàt̪ǎ	ɑ k ɑ ɹ ə ŋ ɑ t ɑ
àl	ɑ l
àláwú	ɑ l ɑ w ʉ
àlbédá	ɑ l b ɛ d ɑ
àlbrìðɔ̀	ɑ l b ɹ i ð ɒ
àlbríð	ɑ l b ɹ i ð
àlbɾíðɔ́	ɑ l b ɾ i ð ɒ
àlè	ɑ l ɛ
àlkùrcɛ́	ɑ l k ʉ ɹ tʃ ɛ
àlkúrcì	ɑ l k ʉ ɹ tʃ i
àlkúɾcɛ́	ɑ l k ʉ ɾ tʃ ɛ
àlmúndù	ɑ l m ʉ n d ʉ
àlmúndɔ̀	ɑ l m ʉ n d ɒ
àlmúnd̪ɔ̀	ɑ l m ʉ n d ɒ
àlò	ɑ l ow
àlpùɾǒ	ɑ l p ʉ ɾ ow
àlú	ɑ l ʉ
àlvárà	ɑ l v ɑ ɹ ɑ
àlvárì	ɑ l v ɑ ɹ i
àlváɾì	ɑ l v ɑ ɾ i
àlvŕðɔ̀	ɑ l v ɹ ð ɒ
àlvɜ́ɽì	ɑ l v ɐ ɹ i
àlvɜ́ɽɔ̀	ɑ l v ɐ ɹ ɒ
àlvɜ́ɽ̀	ɑ l v ɐ ɹ
àlə̀ŋá	ɑ l ə ŋ ɑ
àlɛ́là	ɑ l ɛ l ɑ
àmàcá	ɑ m ɑ tʃ ɑ
àmànɔ́	ɑ m ɑ n ɒ
àmàð	ɑ m ɑ ð
àmàðèðùní	ɑ m ɑ ð ɛ ð ʉ n i
àmál	ɑ m ɑ l
àmìɲá	ɑ m i ɲ ɑ
àmí	ɑ m i
àmnɛ́	ɑ m n ɛ
àmɔ̀nɔ́	ɑ m ɒ n ɒ
àmɔ̀rð	ɑ m ɒ ɹ ð
àmə̀ɾðà	ɑ m ə ɾ ð ɑ
àn	ɑ n
ànàŋà	ɑ n ɑ ŋ ɑ
ànàŋá	ɑ n ɑ ŋ ɑ
ànáò	ɑ n ɑ ow
ànáó	ɑ n ɑ ow
ànáǒ	ɑ n ɑ ow
ànáŋà	ɑ n ɑ ŋ ɑ
ànáŋá	ɑ n ɑ ŋ ɑ
ànìŋì	ɑ n i ŋ i
ànìŋí	ɑ n i ŋ i
àníjò	ɑ n i j ow
àníŋì	ɑ n i ŋ i
àníŋí	ɑ n i ŋ i
ànlì	ɑ n l i
ànlí	ɑ n l i
ànlír	ɑ n l i ɹ
ànò	ɑ n ow
ànó	ɑ n ow
ànt̪á	ɑ n t ɑ
ànt̪ɔ́	ɑ n t ɒ
ànùŋùl	ɑ n ʉ ŋ ʉ l
ànú	ɑ n ʉ
ànúŋûl	ɑ n ʉ ŋ ʉ l
ànúŋûĺ	ɑ n ʉ ŋ ʉ l
ànŋá	ɑ n ŋ ɑ
ànŋgá	ɑ n ŋ ɡ ɑ
ànŋú	ɑ n ŋ ʉ
ànŋúl	ɑ n ŋ ʉ l
ànŋ́gá	ɑ n ŋ ɡ ɑ
ànɔ́ndè	ɑ n ɒ n d ɛ
ànəŋgá	ɑ n ə ŋ ɡ ɑ
ànəŋɛ́n	ɑ n ə ŋ ɛ n
ànə̀	ɑ n ə
ànə́ŋá	ɑ n ə ŋ ɑ
ànə́ŋú	ɑ n ə ŋ ʉ
ànɛ́	ɑ n ɛ
ànɲà	ɑ n ɲ ɑ
ànɲá	ɑ n ɲ ɑ
ànʊ̀	ɑ n ʊ
àǹ	ɑ n
àń	ɑ n
àńŋá	ɑ n ŋ ɑ
àńɟɔ́	ɑ n dʒ ɒ
àòr	ɑ ow ɹ
àór	ɑ ow ɹ
àpá	ɑ p ɑ
àpìt̪í	ɑ p i t i
àpìt̪ɔ́	ɑ p i t ɒ
àprat̪ɔ̀	ɑ p ɹ ɑ t ɒ
àprì	ɑ p ɹ i
àprìɲà	ɑ p ɹ i ɲ ɑ
àprí	ɑ p ɹ i
àpríàɔ̀	ɑ p ɹ i ɑ ɒ
àpríjàtɔ́	ɑ p ɹ i j ɑ t ɒ
àpríjàt̪ɔ́	ɑ p ɹ i j ɑ t ɒ
àprílìdì	ɑ p ɹ i l i d i
àpríɲà	ɑ p ɹ i ɲ ɑ
àpríɲá	ɑ p ɹ i ɲ ɑ
àprɛ̀ɲà	ɑ p ɹ ɛ ɲ ɑ
àpɾì	ɑ p ɾ i
àpɾìɲá	ɑ p ɾ i ɲ ɑ
àpɾí	ɑ p ɾ i
àpɾíɲà	ɑ p ɾ i ɲ ɑ
àpɾíɲá	ɑ p ɾ i ɲ ɑ
àpɾíɲâ	ɑ p ɾ i ɲ ɑ
àpɾíɲǎ	ɑ p ɾ i ɲ ɑ
àràló	ɑ ɹ ɑ l ow
àrá	ɑ ɹ ɑ
àré	ɑ ɹ ɛ
àrlànd̪ɔ́	ɑ ɹ l ɑ n d ɒ
àrlàt̪á	ɑ ɹ l ɑ t ɑ
àrlàt̪â	ɑ ɹ l ɑ t ɑ
àrlá	ɑ ɹ l ɑ
àrlɜ̀nd̪ìjɔ́	ɑ ɹ l ɐ n d i j ɒ
àrò	ɑ ɹ ow
àrt̪ìn	ɑ ɹ t i n
àrt̪ìnɔ̀	ɑ ɹ t i n ɒ
àrt̪ìnɔ́	ɑ ɹ t i n ɒ
àrt̪ɔ́	ɑ ɹ t ɒ
àrù	ɑ ɹ ʉ
àrðá	ɑ ɹ ð ɑ
àrɛ̀mna	ɑ ɹ ɛ m n ɑ
àtə́vɛ̀	ɑ t ə v ɛ
àtə́vɛ̌	ɑ t ə v ɛ
àt̪	ɑ t
àt̪á	ɑ t ɑ
àt̪ábúðà	ɑ t ɑ b ʉ ð ɑ
àt̪ál	ɑ t ɑ l
àt̪ánt̪ɔ̀	ɑ t ɑ n t ɒ
àt̪áŋ	ɑ t ɑ ŋ
àt̪áŋì	ɑ t ɑ ŋ i
àt̪áŋ́	ɑ t ɑ ŋ
àt̪é	ɑ t ɛ
àt̪éɲà	ɑ t ɛ ɲ ɑ
àt̪éɲá	ɑ t ɛ ɲ ɑ
àt̪éɲál	ɑ t ɛ ɲ ɑ l
àt̪éɲár	ɑ t ɛ ɲ ɑ ɹ
àt̪uɟáj	ɑ t ʉ dʒ ɑ j
àt̪ùɟáì	ɑ t ʉ dʒ ɑ i
àt̪ùɟájɛ̀	ɑ t ʉ dʒ ɑ j ɛ
àt̪ùɟájɛ́	ɑ t ʉ dʒ ɑ j ɛ
àt̪ɔ́nt̪ɔ̀	ɑ t ɒ n t ɒ
àt̪ə́và	ɑ t ə v ɑ
àt̪ə́vìnɛ̀	ɑ t ə v i n ɛ
àt̪ə́vɛ̀	ɑ t ə v ɛ
àùɾɛ̀	ɑ ʉ ɾ ɛ
àúr	ɑ ʉ ɹ
àúɾɛ́	ɑ ʉ ɾ ɛ
àvàlà	ɑ v ɑ l ɑ
àvàlá	ɑ v ɑ l ɑ
àvàn	ɑ v ɑ n
àvlà	ɑ v l ɑ
àvlǎ	ɑ v l ɑ
àvɟègɛ̀	ɑ v dʒ ɛ ɡ ɛ
àvɟìgɛ̀	ɑ v dʒ i ɡ ɛ
àvɟìgɛ́	ɑ v dʒ i ɡ ɛ
àvɟìgɛ̂	ɑ v dʒ i ɡ ɛ
àvɟɛ́gɛ́	ɑ v dʒ ɛ ɡ ɛ
àwá	ɑ w ɑ
àwùr	ɑ w ʉ ɹ
àwúɾ	ɑ w ʉ ɾ
àðà	ɑ ð ɑ
àðá	ɑ ð ɑ
àððà	ɑ ð ð ɑ
àððàt̪à	ɑ ð ð ɑ t ɑ
àðə̀ɲɛ́n	ɑ ð ə ɲ ɛ n
àðə̀ɲɛ́nɛ́	ɑ ð ə ɲ ɛ n ɛ
àðɛ́	ɑ ð ɛ
àŋà	ɑ ŋ ɑ
àŋá	ɑ ŋ ɑ
àŋcɔ̀	ɑ ŋ tʃ ɒ
àŋcɔ̌	ɑ ŋ tʃ ɒ
àŋdó	ɑ ŋ d ow
àŋiðèní	ɑ ŋ i ð ɛ n i
àŋná	ɑ ŋ n ɑ
àŋnɔ̀	ɑ ŋ n ɒ
àŋnɔ́	ɑ ŋ n ɒ
àŋɔ̀ŋnìjɔ́	ɑ ŋ ɒ ŋ n i j ɒ
àɟà	ɑ dʒ ɑ
àɲɲà	ɑ ɲ ɲ ɑ
àɲɲá	ɑ ɲ ɲ ɑ
àɲɲǎ	ɑ ɲ ɲ ɑ
àɽà	ɑ ɹ ɑ
àɽàt̪á	ɑ ɹ ɑ t ɑ
àɽàŋgàɾ	ɑ ɹ ɑ ŋ ɡ ɑ ɾ
àɽàŋgàɾɛ̀	ɑ ɹ ɑ ŋ ɡ ɑ ɾ ɛ
àɽàŋgár	ɑ ɹ ɑ ŋ ɡ ɑ ɹ
àɽá	ɑ ɹ ɑ
àɽó	ɑ ɹ ow
àɽə̀ŋàjt̪ɜ́lǒ	ɑ ɹ ə ŋ ɑ j t ɐ l ow
àɾàló	ɑ ɾ ɑ l ow
àɾá	ɑ ɾ ɑ
àɾò	ɑ ɾ ow
àɾòǒ	ɑ ɾ ow ow
àɾtá	ɑ ɾ t ɑ
àɾt̪átɛ́	ɑ ɾ t ɑ t ɛ
àɾt̪átɛ́r	ɑ ɾ t ɑ t ɛ ɹ
àɾt̪íŋì	ɑ ɾ t i ŋ i
àɾt̪íŋǐ	ɑ ɾ t i ŋ i
àɾt̪íɲáɾɛ́	ɑ ɾ t i ɲ ɑ ɾ ɛ
àɾt̪î	ɑ ɾ t i
àɾt̪ɔ́	ɑ ɾ t ɒ
àɾt̪ɔ́l	ɑ ɾ t ɒ l
àɾt̪ɔ́ló	ɑ ɾ t ɒ l ow
àɾðàt̪ɔ́	ɑ ɾ ð ɑ t ɒ
àɾðɔ̀ŋə̀nɔ̀	ɑ ɾ ð ɒ ŋ ə n ɒ
àɾðɔ̀ŋə̀nɔ́	ɑ ɾ ð ɒ ŋ ə n ɒ
àɾɔ̀	ɑ ɾ ɒ
àɾ̀vɛ́	ɑ ɾ v ɛ
à̀prí	ɑ p ɹ i
á	ɑ
áà	ɑ ɑ
áá	ɑ ɑ
ábá	ɑ b ɑ
ábró	ɑ b ɹ ow
ábrô	ɑ b ɹ ow
ábrt̪ɔ́	ɑ b ɹ t ɒ
ábrú	ɑ b ɹ ʉ
ábŕtɔ́	ɑ b ɹ t ɒ
ábùðú	ɑ b ʉ ð ʉ
ábút̪ɔ́	ɑ b ʉ t ɒ
ábúðát̪ɔ́	ɑ b ʉ ð ɑ t ɒ
ábúðú	ɑ b ʉ ð ʉ
ábɔ́ðà	ɑ b ɒ ð ɑ
ábə́ðɔ́	ɑ b ə ð ɒ
ácám	ɑ tʃ ɑ m
ácámá	ɑ tʃ ɑ m ɑ
ádàm	ɑ d ɑ m
ádám	ɑ d ɑ m
ádùrú	ɑ d ʉ ɹ ʉ
ádðɛ́	ɑ d ð ɛ
ádɔ̀ŋnǎ	ɑ d ɒ ŋ n ɑ
ádɔ̀ŋnɔ̀	ɑ d ɒ ŋ n ɒ
ádɔ̀ŋt̪íŋì	ɑ d ɒ ŋ t i ŋ i
ádɔ́ŋnɔ́	ɑ d ɒ ŋ n ɒ
ádɔ́ŋðɛ̀	ɑ d ɒ ŋ ð ɛ
ádɔ́ŋɔ́nɔ́	ɑ d ɒ ŋ ɒ n ɒ
ádə́ɽálɛ̂	ɑ d ə ɹ ɑ l ɛ
ádə́ɽɔ́lɛ́	ɑ d ə ɹ ɒ l ɛ
ádɛ̀ŋnɛ̀	ɑ d ɛ ŋ n ɛ
ádɛ̀ŋnɛ̌	ɑ d ɛ ŋ n ɛ
ád̪ùɾì	ɑ d ʉ ɾ i
áfàn	ɑ f ɑ n
ágàrù	ɑ ɡ ɑ ɹ ʉ
ágàrǔ	ɑ ɡ ɑ ɹ ʉ
ágádúró	ɑ ɡ ɑ d ʉ ɹ ow
ágádúrɔ̀	ɑ ɡ ɑ d ʉ ɹ ɒ
ágád̪úrɔ̀	ɑ ɡ ɑ d ʉ ɹ ɒ
ágád̪úrɔ́	ɑ ɡ ɑ d ʉ ɹ ɒ
ágágâra	ɑ ɡ ɑ ɡ ɑ ɹ ɑ
ágágâɾǎ	ɑ ɡ ɑ ɡ ɑ ɾ ɑ
ágánɔ́nà	ɑ ɡ ɑ n ɒ n ɑ
ágánɔ̂nà	ɑ ɡ ɑ n ɒ n ɑ
ágárŋɔ̀	ɑ ɡ ɑ ɹ ŋ ɒ
ágátɛ́və́lɛ̂ðɛ̀	ɑ ɡ ɑ t ɛ v ə l ɛ ð ɛ
ágátɛ́və́lɛ̂ðɛ̌r	ɑ ɡ ɑ t ɛ v ə l ɛ ð ɛ ɹ
ágát̪ə̀vɔ́	ɑ ɡ ɑ t ə v ɒ
ágávə́lɛ̂ðɛ̀	ɑ ɡ ɑ v ə l ɛ ð ɛ
ágávə́lɛ̂ðɛ̌	ɑ ɡ ɑ v ə l ɛ ð ɛ
ágáð	ɑ ɡ ɑ ð
ágáðɛ́gàɾà	ɑ ɡ ɑ ð ɛ ɡ ɑ ɾ ɑ
ágáðɛ́gàɾǎ	ɑ ɡ ɑ ð ɛ ɡ ɑ ɾ ɑ
ágáŋî	ɑ ɡ ɑ ŋ i
ágáŋîí	ɑ ɡ ɑ ŋ i i
ágáŋîjàjàt̪à	ɑ ɡ ɑ ŋ i j ɑ j ɑ t ɑ
ágáŋîjàt̪à	ɑ ɡ ɑ ŋ i j ɑ t ɑ
ágáŋîmàt̪à	ɑ ɡ ɑ ŋ i m ɑ t ɑ
ágáŋîvlɛ̀ðɔ́	ɑ ɡ ɑ ŋ i v l ɛ ð ɒ
ágáŋîvə̀lɛ̀ðà	ɑ ɡ ɑ ŋ i v ə l ɛ ð ɑ
ágáŋîvə̀lɛ̀ðɛ̀	ɑ ɡ ɑ ŋ i v ə l ɛ ð ɛ
ágáŋîvə̀lɛ̀ðɛ̌	ɑ ɡ ɑ ŋ i v ə l ɛ ð ɛ
ágáŋî́	ɑ ɡ ɑ ŋ i
ágârŋú	ɑ ɡ ɑ ɹ ŋ ʉ
ágâvə̀lɛ̀ðɔ́	ɑ ɡ ɑ v ə l ɛ ð ɒ
ágéɲár	ɑ ɡ ɛ ɲ ɑ ɹ
ágéɲárvə́lɛ̂ðɔ́	ɑ ɡ ɛ ɲ ɑ ɹ v ə l ɛ ð ɒ
ágílà	ɑ ɡ i l ɑ
ágíɲárvə̀lɛ̀ðà	ɑ ɡ i ɲ ɑ ɹ v ə l ɛ ð ɑ
ágíɲárvə́lɛ̀ðà	ɑ ɡ i ɲ ɑ ɹ v ə l ɛ ð ɑ
ágíɲárvə́lɛ̂ðɛ̀	ɑ ɡ i ɲ ɑ ɹ v ə l ɛ ð ɛ
ágíɲárɛ́və́lɛ̀ðà	ɑ ɡ i ɲ ɑ ɹ ɛ v ə l ɛ ð ɑ
ágó	ɑ ɡ ow
ágǒw	ɑ ɡ ow w
ágɛ́là	ɑ ɡ ɛ l ɑ
áít̪ɔ́	ɑ i t ɒ
áíɲár	ɑ i ɲ ɑ ɹ
ájà	ɑ j ɑ
ájàŋà	ɑ j ɑ ŋ ɑ
ájàŋá	ɑ j ɑ ŋ ɑ
ájàŋú	ɑ j ɑ ŋ ʉ
áját̪à	ɑ j ɑ t ɑ
ájáŋrɛ́	ɑ j ɑ ŋ ɹ ɛ
ájáŋ̀	ɑ j ɑ ŋ
ájít̪ɔ́	ɑ j i t ɒ
ájnɛ́	ɑ j n ɛ
ájú	ɑ j ʉ
ájɛ́n	ɑ j ɛ n
ájɛ̌n	ɑ j ɛ n
ákád̪úrɔ̀	ɑ k ɑ d ʉ ɹ ɒ
ákád̪úrɔ́	ɑ k ɑ d ʉ ɹ ɒ
ákɛsa	ɑ k ɛ s ɑ
ákɛ̀	ɑ k ɛ
ál	ɑ l
álakə́lcà	ɑ l ɑ k ə l tʃ ɑ
álágârà	ɑ l ɑ ɡ ɑ ɹ ɑ
álágâràr	ɑ l ɑ ɡ ɑ ɹ ɑ ɹ
álágârá	ɑ l ɑ ɡ ɑ ɹ ɑ
álárɛ́	ɑ l ɑ ɹ ɛ
álávə́lɛ̂ðɛ̀	ɑ l ɑ v ə l ɛ ð ɛ
álávə́lɛ̂ðɛ́r	ɑ l ɑ v ə l ɛ ð ɛ ɹ
álávə́lɛ̂ðɛ̌	ɑ l ɑ v ə l ɛ ð ɛ
áláðə́gârà	ɑ l ɑ ð ə ɡ ɑ ɹ ɑ
áláðə́gâràr	ɑ l ɑ ð ə ɡ ɑ ɹ ɑ ɹ
áláðə́gârár	ɑ l ɑ ð ə ɡ ɑ ɹ ɑ ɹ
áláðɛ́gâɾǎ	ɑ l ɑ ð ɛ ɡ ɑ ɾ ɑ
áláðɛ́lǎ	ɑ l ɑ ð ɛ l ɑ
áláɽə̀ŋàt̪à	ɑ l ɑ ɹ ə ŋ ɑ t ɑ
áláɽə̀ŋàt̪ǎ	ɑ l ɑ ɹ ə ŋ ɑ t ɑ
áláɽə̀ŋàt̪ǎr	ɑ l ɑ ɹ ə ŋ ɑ t ɑ ɹ
álâvə̀lɛ̀ðɔ́	ɑ l ɑ v ə l ɛ ð ɒ
álâvə̀lɛ̀ðɔ́r	ɑ l ɑ v ə l ɛ ð ɒ ɹ
álbrìðɔ̀	ɑ l b ɹ i ð ɒ
álbríðɔ̀	ɑ l b ɹ i ð ɒ
álbríðɔ́	ɑ l b ɹ i ð ɒ
áldɔ́ŋðà	ɑ l d ɒ ŋ ð ɑ
áldɔ́ŋðɛ̀	ɑ l d ɒ ŋ ð ɛ
álkùrcɛ́	ɑ l k ʉ ɹ tʃ ɛ
álkúrcì	ɑ l k ʉ ɹ tʃ i
álkə́lcà	ɑ l k ə l tʃ ɑ
álkə́lcì	ɑ l k ə l tʃ i
állárɔ́	ɑ l l ɑ ɹ ɒ
állárɔ́ðà	ɑ l l ɑ ɹ ɒ ð ɑ
állów	ɑ l l ow w
álò	ɑ l ow
áló	ɑ l ow
álpùrɔ́	ɑ l p ʉ ɹ ɒ
álpùɾǒ	ɑ l p ʉ ɾ ow
álpúró	ɑ l p ʉ ɹ ow
álpúrɔ́	ɑ l p ʉ ɹ ɒ
álpúɾó	ɑ l p ʉ ɾ ow
álpúɾɔ́	ɑ l p ʉ ɾ ɒ
álpʊ́ɾɔ́	ɑ l p ʊ ɾ ɒ
álpʊ́ɾɔ̂	ɑ l p ʊ ɾ ɒ
ált̪ɔ́t̪ɛ̀	ɑ l t ɒ t ɛ
álú	ɑ l ʉ
álə́ŋɔ́	ɑ l ə ŋ ɒ
álɛ̀	ɑ l ɛ
álɛ́	ɑ l ɛ
álɛ́là	ɑ l ɛ l ɑ
álɛ́làŕ	ɑ l ɛ l ɑ ɹ
álɛ̌	ɑ l ɛ
álɜ́úr	ɑ l ɐ ʉ ɹ
ámàl	ɑ m ɑ l
ámácí	ɑ m ɑ tʃ i
ámácíì	ɑ m ɑ tʃ i i
ámácíŋì	ɑ m ɑ tʃ i ŋ i
ámál	ɑ m ɑ l
ámálà	ɑ m ɑ l ɑ
ámálá	ɑ m ɑ l ɑ
ámálɛ́	ɑ m ɑ l ɛ
ámíɲí	ɑ m i ɲ i
ámúðɛ́	ɑ m ʉ ð ɛ
ámɔ̀rðɛ̀	ɑ m ɒ ɹ ð ɛ
ámɔ́nɔ́	ɑ m ɒ n ɒ
ámɔ́ŋnɔ́	ɑ m ɒ ŋ n ɒ
ámə̀rðàðɛ̀	ɑ m ə ɹ ð ɑ ð ɛ
ámə̀rðɛ̀	ɑ m ə ɹ ð ɛ
ámə̀ɾðà	ɑ m ə ɾ ð ɑ
án	ɑ n
ánàrɛ	ɑ n ɑ ɹ ɛ
ánàŋá	ɑ n ɑ ŋ ɑ
áná	ɑ n ɑ
ánìŋì	ɑ n i ŋ i
ánìŋí	ɑ n i ŋ i
ánìŋǐ	ɑ n i ŋ i
ánò	ɑ n ow
ánó	ɑ n ow
ánóɟò	ɑ n ow dʒ ow
ánô	ɑ n ow
ánt̪	ɑ n t
ánt̪ɔ̀	ɑ n t ɒ
ánt̪ɔ́	ɑ n t ɒ
ánù	ɑ n ʉ
ánú	ɑ n ʉ
ánû	ɑ n ʉ
ánŋgá	ɑ n ŋ ɡ ɑ
ánɔŋga	ɑ n ɒ ŋ ɡ ɑ
ánɔ́	ɑ n ɒ
áń	ɑ n
áò	ɑ ow
áòr	ɑ ow ɹ
áór	ɑ ow ɹ
áǒ	ɑ ow
áp	ɑ p
ápà	ɑ p ɑ
ápátɛ̀	ɑ p ɑ t ɛ
ápít̪í	ɑ p i t i
ápít̪íŋí	ɑ p i t i ŋ i
ápr	ɑ p ɹ
ápri	ɑ p ɹ i
áprì	ɑ p ɹ i
áprìɲà	ɑ p ɹ i ɲ ɑ
áprí	ɑ p ɹ i
ápríɲá	ɑ p ɹ i ɲ ɑ
ápríɲâ	ɑ p ɹ i ɲ ɑ
áprî	ɑ p ɹ i
áprǐ	ɑ p ɹ i
ápɔ̀	ɑ p ɒ
ápɔ́	ɑ p ɒ
ápɛ̀	ɑ p ɛ
ápɾ	ɑ p ɾ
ápɾì	ɑ p ɾ i
ápɾìɲà	ɑ p ɾ i ɲ ɑ
ápɾìɲá	ɑ p ɾ i ɲ ɑ
ápɾí	ɑ p ɾ i
ápɾíŋà	ɑ p ɾ i ŋ ɑ
ápɾíɲ	ɑ p ɾ i ɲ
ápɾíɲà	ɑ p ɾ i ɲ ɑ
ápɾíɲá	ɑ p ɾ i ɲ ɑ
ápɾíɲâá	ɑ p ɾ i ɲ ɑ ɑ
ár	ɑ ɹ
árà	ɑ ɹ ɑ
árá	ɑ ɹ ɑ
árâá	ɑ ɹ ɑ ɑ
árǎ	ɑ ɹ ɑ
árè	ɑ ɹ ɛ
áré	ɑ ɹ ɛ
árlát̪ɔ́	ɑ ɹ l ɑ t ɒ
árlɔ́	ɑ ɹ l ɒ
áróŋòr	ɑ ɹ ow ŋ ow ɹ
ártɛ̀	ɑ ɹ t ɛ
árt̪ɔ̀	ɑ ɹ t ɒ
árt̪ɔ́	ɑ ɹ t ɒ
árt̪ɔ́l	ɑ ɹ t ɒ l
árt̪ɔ́ló	ɑ ɹ t ɒ l ow
árt̪ɛ̀	ɑ ɹ t ɛ
árú	ɑ ɹ ʉ
árðát̪ɔ́	ɑ ɹ ð ɑ t ɒ
árðáŋə́nɔ́	ɑ ɹ ð ɑ ŋ ə n ɒ
árðɔ́	ɑ ɹ ð ɒ
árðɛ̀	ɑ ɹ ð ɛ
árɛ́	ɑ ɹ ɛ
ásà	ɑ s ɑ
ásá	ɑ s ɑ
ásǎ	ɑ s ɑ
át̪ájàt̪à	ɑ t ɑ j ɑ t ɑ
át̪ə́vìnɛ̀	ɑ t ə v i n ɛ
át̪ə́vɛ̀	ɑ t ə v ɛ
át̪ə́vɛ̌	ɑ t ə v ɛ
áúr	ɑ ʉ ɹ
ávàn	ɑ v ɑ n
áván	ɑ v ɑ n
ávé	ɑ v ɛ
ávlɛ̀ðɛ́ŋì	ɑ v l ɛ ð ɛ ŋ i
ávt̪ɔ́	ɑ v t ɒ
ávə̀lɛ̀ðìnɔ́	ɑ v ə l ɛ ð i n ɒ
ávə̀lɛ̀ðɛ́ŋì	ɑ v ə l ɛ ð ɛ ŋ i
ávə̀lɛ̀ðɛ́ɲárɛ̀	ɑ v ə l ɛ ð ɛ ɲ ɑ ɹ ɛ
ávə̀lɛ̀ðɛ́ɲárɛ́	ɑ v ə l ɛ ð ɛ ɲ ɑ ɹ ɛ
ávə̀lɛ̀ðɛ́ɲáɾɛ̀	ɑ v ə l ɛ ð ɛ ɲ ɑ ɾ ɛ
ávə̀lɛ̀ðɛ́ɲáɾɛ́	ɑ v ə l ɛ ð ɛ ɲ ɑ ɾ ɛ
ávə́lɛ̀ðà	ɑ v ə l ɛ ð ɑ
ávə́ðácí	ɑ v ə ð ɑ tʃ i
ávɛ̀	ɑ v ɛ
ávɟìgɛ̀	ɑ v dʒ i ɡ ɛ
ávɟìgɛ́	ɑ v dʒ i ɡ ɛ
áwó	ɑ w ow
áwô	ɑ w ow
áwùr	ɑ w ʉ ɹ
áwùɾ	ɑ w ʉ ɾ
áwúɾ	ɑ w ʉ ɾ
áŋ	ɑ ŋ
áŋà	ɑ ŋ ɑ
áŋál	ɑ ŋ ɑ l
áŋátɛ́	ɑ ŋ ɑ t ɛ
áŋê	ɑ ŋ ɛ
áŋí	ɑ ŋ i
áŋíŋídeɛ́	ɑ ŋ i ŋ i d ɛ ɛ
áŋíɲár	ɑ ŋ i ɲ ɑ ɹ
áŋîvə̀lɛ̀ðà	ɑ ŋ i v ə l ɛ ð ɑ
áŋîvə̀lɛ̀ðɛ̀	ɑ ŋ i v ə l ɛ ð ɛ
áŋnà	ɑ ŋ n ɑ
áŋná	ɑ ŋ n ɑ
áŋó	ɑ ŋ ow
áŋtɛ́	ɑ ŋ t ɛ
áŋú	ɑ ŋ ʉ
áŋɔ̀ŋnɔ̀	ɑ ŋ ɒ ŋ n ɒ
áŋɔ̀ŋnɔ́	ɑ ŋ ɒ ŋ n ɒ
áŋɔ́ŋní	ɑ ŋ ɒ ŋ n i
áŋɔ́ŋníjí	ɑ ŋ ɒ ŋ n i j i
áɛ	ɑ ɛ
áɟó	ɑ dʒ ow
áɟɔ́ŋá	ɑ dʒ ɒ ŋ ɑ
áɽàŋgàɾ	ɑ ɹ ɑ ŋ ɡ ɑ ɾ
áɽàŋgàɾɛ̀	ɑ ɹ ɑ ŋ ɡ ɑ ɾ ɛ
áɽàŋgár	ɑ ɹ ɑ ŋ ɡ ɑ ɹ
áɽát̪ɔ́	ɑ ɹ ɑ t ɒ
áɽáŋgár	ɑ ɹ ɑ ŋ ɡ ɑ ɹ
áɽíðú	ɑ ɹ i ð ʉ
áɽó	ɑ ɹ ow
áɽə̀ŋàt̪ò	ɑ ɹ ə ŋ ɑ t ow
áɽə̀ŋàt̪ó	ɑ ɹ ə ŋ ɑ t ow
áɽə́ŋájt̪éló	ɑ ɹ ə ŋ ɑ j t ɛ l ow
áɽə́ŋájt̪ɜ́ló	ɑ ɹ ə ŋ ɑ j t ɐ l ow
áɽə́ŋájt̪ɜ́lǒ	ɑ ɹ ə ŋ ɑ j t ɐ l ow
áɽə́ŋátô	ɑ ɹ ə ŋ ɑ t ow
áɽə́ŋát̪ó	ɑ ɹ ə ŋ ɑ t ow
áɽə́ŋát̪ór	ɑ ɹ ə ŋ ɑ t ow ɹ
áɾà	ɑ ɾ ɑ
áɾò	ɑ ɾ ow
áɾt̪átɛ́	ɑ ɾ t ɑ t ɛ
áɾt̪áŋáŋ́ɲár	ɑ ɾ t ɑ ŋ ɑ ŋ ɲ ɑ ɹ
áɾt̪íǐ	ɑ ɾ t i i
áɾt̪ínɔ́r	ɑ ɾ t i n ɒ ɹ
áɾt̪íŋí	ɑ ɾ t i ŋ i
áɾt̪ɔ́	ɑ ɾ t ɒ
áɾt̪ɔ́l	ɑ ɾ t ɒ l
áɾɔ́	ɑ ɾ ɒ
á̀ɾt̪ɔ́	ɑ ɾ t ɒ
á́	ɑ
á̂ɾt̪ɔ́	ɑ ɾ t ɒ
âbùðú	ɑ b ʉ ð ʉ
âdɔ̀ŋnà	ɑ d ɒ ŋ n ɑ
âdɔ̀ŋnɔ́	ɑ d ɒ ŋ n ɒ
âjt̪ɔ́	ɑ j t ɒ
ânlí	ɑ n l i
âó	ɑ ow
âprát̪à	ɑ p ɹ ɑ t ɑ
âré	ɑ ɹ ɛ
ât̪ɔ́	ɑ t ɒ
âu	ɑ ʉ
âvlɛ̀ðɛ̌ɲárɛ́	ɑ v l ɛ ð ɛ ɲ ɑ ɹ ɛ
âvɟègɛ̀	ɑ v dʒ ɛ ɡ ɛ
âw	ɑ w
âŋt̪átɛ̀	ɑ ŋ t ɑ t ɛ
âŋt̪átɛ́	ɑ ŋ t ɑ t ɛ
âŋú	ɑ ŋ ʉ
âɾù	ɑ ɾ ʉ
ǎ	ɑ
ǎgánɔ̂nǎ	ɑ ɡ ɑ n ɒ n ɑ
ǎgáŋîvlɛ̀ðɔ́	ɑ ɡ ɑ ŋ i v l ɛ ð ɒ
ǎj	ɑ j
ǎl	ɑ l
ǎn	ɑ n
ǎnɔ́ndí	ɑ n ɒ n d i
ǎŋèðìní	ɑ ŋ ɛ ð i n i
bacʊm	b ɑ tʃ ʊ m
bàcùm	b ɑ tʃ ʉ m
bàcúm	b ɑ tʃ ʉ m
bàcʊ́m	b ɑ tʃ ʊ m
bàcʊ́mŋó	b ɑ tʃ ʊ m ŋ ow
bàcʊ́mɛ́	b ɑ tʃ ʊ m ɛ
bàcʊ̂m	b ɑ tʃ ʊ m
bàcʊ̂ḿ	b ɑ tʃ ʊ m
bácóm	b ɑ tʃ ow m
bácómâ	b ɑ tʃ ow m ɑ
bácómɛ̀	b ɑ tʃ ow m ɛ
bácómɛ́	b ɑ tʃ ow m ɛ
bácóm̀	b ɑ tʃ ow m
bácúm	b ɑ tʃ ʉ m
bácʊ́m	b ɑ tʃ ʊ m
bácʊ̂m	b ɑ tʃ ʊ m
bâcòm	b ɑ tʃ ow m
bâcòmɛ̀	b ɑ tʃ ow m ɛ
bŕɽàɽìðì	b ɹ ɹ ɑ ɹ i ð i
bùlà	b ʉ l ɑ
bùlìjɔ́	b ʉ l i j ɒ
bú	b ʉ
búlíjí	b ʉ l i j i
búr	b ʉ ɹ
bû	b ʉ
bɔ̀là	b ɒ l ɑ
bɔ̀lá	b ɒ l ɑ
bɔ́lɔ̀	b ɒ l ɒ
bɔ́lɔ́	b ɒ l ɒ
bə̀ɽâló	b ə ɹ ɑ l ow
bə̀ɽɔ́	b ə ɹ ɒ
bə́ɽáló	b ə ɹ ɑ l ow
bə́ɽɔ́	b ə ɹ ɒ
bɛ́tɛ̀n	b ɛ t ɛ n
bɛ́tɛ̀ń	b ɛ t ɛ n
bɽɔ́	b ɹ ɒ
bʊ̀gʊ́l	b ʊ ɡ ʊ l
bʊ́lʊ̀	b ʊ l ʊ
bʊ́lʊ́	b ʊ l ʊ
cà	tʃ ɑ
càtà	tʃ ɑ t ɑ
càt̪à	tʃ ɑ t ɑ
càt̪á	tʃ ɑ t ɑ
cálà	tʃ ɑ l ɑ
cátà	tʃ ɑ t ɑ
cátá	tʃ ɑ t ɑ
cǎ	tʃ ɑ
cìcɔ̀	tʃ i tʃ ɒ
cìcə̀lò	tʃ i tʃ ə l ow
cìlá	tʃ i l ɑ
cìŋgə̀làlá	tʃ i ŋ ɡ ə l ɑ l ɑ
cíló	tʃ i l ow
cíŋgə́lálí	tʃ i ŋ ɡ ə l ɑ l i
cló	tʃ l ow
cùbò	tʃ ʉ b ow
cùbó	tʃ ʉ b ow
cùcù	tʃ ʉ tʃ ʉ
cùcú	tʃ ʉ tʃ ʉ
cùmú	tʃ ʉ m ʉ
cúcù	tʃ ʉ tʃ ʉ
cúmú	tʃ ʉ m ʉ
cɔ́	tʃ ɒ
cɔ̌	tʃ ɒ
cə́là	tʃ ə l ɑ
cʊ̀mù	tʃ ʊ m ʉ
cʊ̀mú	tʃ ʊ m ʉ
dè	d ɛ
dé	d ɛ
dě	d ɛ
dijo	d i j ow
dì	d i
dìjàló	d i j ɑ l ow
dìjò	d i j ow
dìjó	d i j ow
dìjɔ́	d i j ɒ
dìó	d i ow
dí	d i
díjàlo	d i j ɑ l ow
díjàlò	d i j ɑ l ow
díjí	d i j i
díjò	d i j ow
díjó	d i j ow
díjɔ̀	d i j ɒ
díjɔ́	d i j ɒ
díò	d i ow
dlún	d l ʉ n
dòrèɲà	d ow ɹ ɛ ɲ ɑ
dòrì	d ow ɹ i
dòɾè	d ow ɾ ɛ
dòɾèɲà	d ow ɾ ɛ ɲ ɑ
dòɾě	d ow ɾ ɛ
dòɾì	d ow ɾ i
dòɾǐ	d ow ɾ i
dórì	d ow ɹ i
dun	d ʉ n
dù	d ʉ
dùdɔ̀	d ʉ d ɒ
dùn	d ʉ n
dùɽáɾɛ́	d ʉ ɹ ɑ ɾ ɛ
dún	d ʉ n
dúnŋù	d ʉ n ŋ ʉ
dúpà	d ʉ p ɑ
dúrû	d ʉ ɹ ʉ
dúɛ̀t̪ɛ̌	d ʉ ɛ t ɛ
dɔ̀	d ɒ
dɔ̀ŋðàt̪á	d ɒ ŋ ð ɑ t ɑ
dɔ̀ŋðá	d ɒ ŋ ð ɑ
dɔ̀ŋðɔ̀	d ɒ ŋ ð ɒ
dɔ̀ŋðɔ́	d ɒ ŋ ð ɒ
dɔ̀ŋðɛ̀	d ɒ ŋ ð ɛ
dɔ́	d ɒ
dɔ́ŋðà	d ɒ ŋ ð ɑ
dɔ́ŋðát̪ɔ́	d ɒ ŋ ð ɑ t ɒ
dɔ́ŋðɔ́	d ɒ ŋ ð ɒ
dɔ́ŋðɛ̀	d ɒ ŋ ð ɛ
dɔ́ɽðàt̪à	d ɒ ɹ ð ɑ t ɑ
dɛ	d ɛ
dɛ̀	d ɛ
dɛ́	d ɛ
dɛ́ðà	d ɛ ð ɑ
dɛ̂	d ɛ
dɛ̌	d ɛ
d̪ù	d ʉ
d̪ùd̪ɔ̀	d ʉ d ɒ
d̪ùd̪ɔ̌	d ʉ d ɒ
d̪ùrɔ́	d ʉ ɹ ɒ
d̪úd̪ɔ̀	d ʉ d ɒ
d̪úd̪ɔ́	d ʉ d ɒ
d̪úrú	d ʉ ɹ ʉ
d̪úrɔ̌	d ʉ ɹ ɒ
d̪úɾǐ	d ʉ ɾ i
d̪úɾú	d ʉ ɾ ʉ
d̪ʊ̀ɾɔ̀	d ʊ ɾ ɒ
d̪ʊ̀ɾɔ́	d ʊ ɾ ɒ
d̪ʊ̀ɾɔ̂	d ʊ ɾ ɒ
d̪ʊ́ɾɔ́t̪ɔ́	d ʊ ɾ ɒ t ɒ
d̪ʊ́ɾʊ́	d ʊ ɾ ʊ
e	ɛ
edárɛ́n	ɛ d ɑ ɹ ɛ n
edɛrɛ́	ɛ d ɛ ɹ ɛ
ed̪ɔɽɔlɛdel	ɛ d ɒ ɹ ɒ l ɛ d ɛ l
ed̪ɛɾɛ́	ɛ d ɛ ɾ ɛ
eðɛ	ɛ ð ɛ
eɽdɔ́gɛ́	ɛ ɹ d ɒ ɡ ɛ
èbéj	ɛ b ɛ j
ècə̀lò	ɛ tʃ ə l ow
èdáràló	ɛ d ɑ ɹ ɑ l ow
èddèré	ɛ d d ɛ ɹ ɛ
èdì	ɛ d i
èdìrá	ɛ d i ɹ ɑ
èdɔ̀ɽɔ̀	ɛ d ɒ ɹ ɒ
èdɔ̀ɽɔ̌	ɛ d ɒ ɹ ɒ
èdə̀ɽɔ̀l	ɛ d ə ɹ ɒ l
èdɛ̀rɛ̀	ɛ d ɛ ɹ ɛ
èdɛ̀rɛ́	ɛ d ɛ ɹ ɛ
èdɛ̀ɽì	ɛ d ɛ ɹ i
èdɛ̀ɽɔ̀	ɛ d ɛ ɹ ɒ
èdɛ̀ɾ	ɛ d ɛ ɾ
èdɛ̀ɾá	ɛ d ɛ ɾ ɑ
èdɛ̀ɾɛ̀	ɛ d ɛ ɾ ɛ
èdɛ̀ɾɛ́	ɛ d ɛ ɾ ɛ
èdɜ́rə́lù	ɛ d ɐ ɹ ə l ʉ
èd̪èɾá	ɛ d ɛ ɾ ɑ
èd̪ɔ̀ɽɔ̀l	ɛ d ɒ ɹ ɒ l
èd̪ɔ̀ɽɔ̀lɛ̀	ɛ d ɒ ɹ ɒ l ɛ
èd̪ɔ̀ɽɔ̌l	ɛ d ɒ ɹ ɒ l
èd̪ɛ̀rɛ̀	ɛ d ɛ ɹ ɛ
èd̪ɛ̀rɛ́	ɛ d ɛ ɹ ɛ
èd̪ɛ̀ɾ	ɛ d ɛ ɾ
èd̪ɛ̀ɾɛ́	ɛ d ɛ ɾ ɛ
èd̪ɛ́ɾɛ́	ɛ d ɛ ɾ ɛ
èít̪éɲárɛ́	ɛ i t ɛ ɲ ɑ ɹ ɛ
èlái	ɛ l ɑ i
èlè	ɛ l ɛ
èlě	ɛ l ɛ
èmànàlò	ɛ m ɑ n ɑ l ow
èmànàló	ɛ m ɑ n ɑ l ow
èmànáj	ɛ m ɑ n ɑ j
èmànɛ̀n	ɛ m ɑ n ɛ n
èmàð	ɛ m ɑ ð
èmàðàlú	ɛ m ɑ ð ɑ l ʉ
èmàɽðén	ɛ m ɑ ɹ ð ɛ n
èmàɽðín	ɛ m ɑ ɹ ð i n
èmàɽðɛ̀n	ɛ m ɑ ɹ ð ɛ n
èmàɽðɛ́n	ɛ m ɑ ɹ ð ɛ n
èmàɽðɛ́ná	ɛ m ɑ ɹ ð ɛ n ɑ
èmàɾðɛ́n	ɛ m ɑ ɾ ð ɛ n
èmáð	ɛ m ɑ ð
èmáðɛ́	ɛ m ɑ ð ɛ
èráð	ɛ ɹ ɑ ð
èrnà	ɛ ɹ n ɑ
èrt̪á	ɛ ɹ t ɑ
èsám	ɛ s ɑ m
èt̪éɲáré	ɛ t ɛ ɲ ɑ ɹ ɛ
èvàrt̪ɔ̀	ɛ v ɑ ɹ t ɒ
èvə́lɛ̀ðà	ɛ v ə l ɛ ð ɑ
èðè	ɛ ð ɛ
èðé	ɛ ð ɛ
èðɔ̀ŋ	ɛ ð ɒ ŋ
èðɔ̀ŋɔ̀	ɛ ð ɒ ŋ ɒ
èðɛ̀	ɛ ð ɛ
èðɛ́	ɛ ð ɛ
èŋgáð	ɛ ŋ ɡ ɑ ð
èŋɛ̀ɾà	ɛ ŋ ɛ ɾ ɑ
èŋɛ̀ɾɔ̀	ɛ ŋ ɛ ɾ ɒ
èɽdógɛ́	ɛ ɹ d ow ɡ ɛ
èɽdɔ́	ɛ ɹ d ɒ
èɽò	ɛ ɹ ow
èɽó	ɛ ɹ ow
èɽǒ	ɛ ɹ ow
èɾɛ́ð	ɛ ɾ ɛ ð
é	ɛ
ébàló	ɛ b ɑ l ow
édì	ɛ d i
édìrá	ɛ d i ɹ ɑ
édí	ɛ d i
édíjɛ̂	ɛ d i j ɛ
édɔ̀ɽɔ̀	ɛ d ɒ ɹ ɒ
édɔ̀ɽɔ́	ɛ d ɒ ɹ ɒ
édɔ̀ɽɔ̌	ɛ d ɒ ɹ ɒ
édɔ̌	ɛ d ɒ
édə́ɽɔ́lɛ́	ɛ d ə ɹ ɒ l ɛ
édə́ɽɔ́lɛ̂	ɛ d ə ɹ ɒ l ɛ
édɛ̀rɛ́	ɛ d ɛ ɹ ɛ
édɛ̀ɽɔ̀	ɛ d ɛ ɹ ɒ
édɛ́ràló	ɛ d ɛ ɹ ɑ l ow
édɛ́rɛ́	ɛ d ɛ ɹ ɛ
édɜ́rɜ̀lír	ɛ d ɐ ɹ ɐ l i ɹ
édɜ̂rɜ̀lì	ɛ d ɐ ɹ ɐ l i
éd̪ɛ̀rɛ́	ɛ d ɛ ɹ ɛ
égàló	ɛ ɡ ɑ l ow
égàró	ɛ ɡ ɑ ɹ ow
égàrɔ́	ɛ ɡ ɑ ɹ ɒ
égó	ɛ ɡ ow
égùn	ɛ ɡ ʉ n
égún	ɛ ɡ ʉ n
égûn	ɛ ɡ ʉ n
élà	ɛ l ɑ
élàló	ɛ l ɑ l ow
émàɽðɛ́n	ɛ m ɑ ɹ ð ɛ n
émàɽðɛ́ná	ɛ m ɑ ɹ ð ɛ n ɑ
émáðɛ́	ɛ m ɑ ð ɛ
émnà	ɛ m n ɑ
énônɛ̀	ɛ n ow n ɛ
énɔ̀ná	ɛ n ɒ n ɑ
énɔ̀nɔ́	ɛ n ɒ n ɒ
éràmná	ɛ ɹ ɑ m n ɑ
érá	ɛ ɹ ɑ
éróŋòr	ɛ ɹ ow ŋ ow ɹ
évé	ɛ v ɛ
évə́lɛ̀ðɛ̀	ɛ v ə l ɛ ð ɛ
éðè	ɛ ð ɛ
éðìɲú	ɛ ð i ɲ ʉ
éðìɲɔ́	ɛ ð i ɲ ɒ
éɲàvə̀lɛ̀ðɔ́	ɛ ɲ ɑ v ə l ɛ ð ɒ
éɲá	ɛ ɲ ɑ
éɲárvə́lɛ̂ðǎ	ɛ ɲ ɑ ɹ v ə l ɛ ð ɑ
éɲávə́lɛ̀ðà	ɛ ɲ ɑ v ə l ɛ ð ɑ
éɲáŋɔ̀ŋnɔ̀	ɛ ɲ ɑ ŋ ɒ ŋ n ɒ
éɲâ	ɛ ɲ ɑ
éɲâŋɔ̀ŋnɔ́	ɛ ɲ ɑ ŋ ɒ ŋ n ɒ
éɲɔ̂ŋɔ̀ŋn	ɛ ɲ ɒ ŋ ɒ ŋ n
éɽò	ɛ ɹ ow
éɾ	ɛ ɾ
éɾɛ̀ð	ɛ ɾ ɛ ð
ělǐ	ɛ l i
ěr	ɛ ɹ
gaŋɔ́ɽɟɛ̀cà	ɡ ɑ ŋ ɒ ɹ dʒ ɛ tʃ ɑ
gàðə́gârà	ɡ ɑ ð ə ɡ ɑ ɹ ɑ
gàðə́gârá	ɡ ɑ ð ə ɡ ɑ ɹ ɑ
gàɾ	ɡ ɑ ɾ
gáj	ɡ ɑ j
gájínɔ̀	ɡ ɑ j i n ɒ
gájínɔ́	ɡ ɑ j i n ɒ
gákáɾìðà	ɡ ɑ k ɑ ɾ i ð ɑ
gákáɾìðàǎ	ɡ ɑ k ɑ ɾ i ð ɑ ɑ
gálò	ɡ ɑ l ow
gán	ɡ ɑ n
gáŋá	ɡ ɑ ŋ ɑ
gáŋɔ́nà	ɡ ɑ ŋ ɒ n ɑ
gáŋɔ́nìðá	ɡ ɑ ŋ ɒ n i ð ɑ
gáɾɔ́g	ɡ ɑ ɾ ɒ ɡ
gdɔ̀ɽðɔ̀t̪ɔ̀	ɡ d ɒ ɹ ð ɒ t ɒ
gdɔ̀ɽðɔ̀t̪ɔ́	ɡ d ɒ ɹ ð ɒ t ɒ
gìcó	ɡ i tʃ ow
gíɲágɛ́rɛ̌	ɡ i ɲ ɑ ɡ ɛ ɹ ɛ
gǐɲàgɛ́	ɡ i ɲ ɑ ɡ ɛ
gùbúlɔ̀	ɡ ʉ b ʉ l ɒ
gúɽì	ɡ ʉ ɹ i
gɛ	ɡ ɛ
gɛ̀	ɡ ɛ
gɛ̀áðɛ́	ɡ ɛ ɑ ð ɛ
gɛ̀rɛ́	ɡ ɛ ɹ ɛ
gɛ́	ɡ ɛ
gɛ̂	ɡ ɛ
gɛ̂ɛ́	ɡ ɛ ɛ
gɛ̌	ɡ ɛ
gʊ̀blɔ̀ŋnɔ́	ɡ ʊ b l ɒ ŋ n ɒ
gʊ̀bʊ́lɔ̀	ɡ ʊ b ʊ l ɒ
gʊ̀bʊ̂l	ɡ ʊ b ʊ l
hágàró	h ɑ ɡ ɑ ɹ ow
hágàrú	h ɑ ɡ ɑ ɹ ʉ
hágàrǔ	h ɑ ɡ ɑ ɹ ʉ
hágárɔ́ðà	h ɑ ɡ ɑ ɹ ɒ ð ɑ
híŋgárɔ́ðà	h i ŋ ɡ ɑ ɹ ɒ ð ɑ
híŋgáðə́rɔ̀ðà	h i ŋ ɡ ɑ ð ə ɹ ɒ ð ɑ
híŋgɔ́rɔ́ðà	h i ŋ ɡ ɒ ɹ ɒ ð ɑ
húrì	h ʉ ɹ i
hɛ́ŋgárɔ́ðà	h ɛ ŋ ɡ ɑ ɹ ɒ ð ɑ
hɛ́ŋgɔ́ràðà	h ɛ ŋ ɡ ɒ ɹ ɑ ð ɑ
hɛ́ŋgɔ́rɔ́ðà	h ɛ ŋ ɡ ɒ ɹ ɒ ð ɑ
i	i
idǎŋà	i d ɑ ŋ ɑ
ilə̀vcí	i l ə v tʃ i
imaɽðɛn	i m ɑ ɹ ð ɛ n
imàɽðɛ́n	i m ɑ ɹ ð ɛ n
iðɔŋ	i ð ɒ ŋ
iŋgavəlɛðar	i ŋ ɡ ɑ v ə l ɛ ð ɑ ɹ
iŋgaŋaja	i ŋ ɡ ɑ ŋ ɑ j ɑ
iŋgánɔ́nà	i ŋ ɡ ɑ n ɒ n ɑ
iŋgela	i ŋ ɡ ɛ l ɑ
iŋgóɽɛ́	i ŋ ɡ ow ɹ ɛ
iŋgɔ́nɔ́nà	i ŋ ɡ ɒ n ɒ n ɑ
ìbɛ̀j	i b ɛ j
ìbɛ̀n	i b ɛ n
ìbɛ́n	i b ɛ n
ìbɜ̀lí	i b ɐ l i
ìbɜ̀lír	i b ɐ l i ɹ
ìbɜ̀lʊ́	i b ɐ l ʊ
ìclò	i tʃ l ow
ìcɔ̀	i tʃ ɒ
ìcə̀lò	i tʃ ə l ow
ìdárɛ̀j	i d ɑ ɹ ɛ j
ìdáŋà	i d ɑ ŋ ɑ
ìdáŋá	i d ɑ ŋ ɑ
ìdáŋgɛ́	i d ɑ ŋ ɡ ɛ
ìdì	i d i
ìdìjí	i d i j i
ìdú	i d ʉ
ìdɔ̀t̪ɔ̀	i d ɒ t ɒ
ìdɔ̀t̪ɔ́	i d ɒ t ɒ
ìdɔ̀ɽɔ̀	i d ɒ ɹ ɒ
ìdɔ́	i d ɒ
ìdɛ̀rɛ̀n	i d ɛ ɹ ɛ n
ìdɛ̀ɽɔ̀	i d ɛ ɹ ɒ
ìdɛ́rɛ́j	i d ɛ ɹ ɛ j
ìdɜ̀ɽì	i d ɐ ɹ i
ìdɜ́rɜ̀lír	i d ɐ ɹ ɐ l i ɹ
ìdɜ́rɜ̀lú	i d ɐ ɹ ɐ l ʉ
ìdɜ̂rɜ̀lí	i d ɐ ɹ ɐ l i
ìgùn	i ɡ ʉ n
ìjàlʊ́	i j ɑ l ʊ
ìjàt̪á	i j ɑ t ɑ
ìjá	i j ɑ
ìjáj	i j ɑ j
ìjánó	i j ɑ n ow
ìjár	i j ɑ ɹ
ìjèðá	i j ɛ ð ɑ
ìjò	i j ow
ìjó	i j ow
ìjǒ	i j ow
ìjɔ̀	i j ɒ
ìjɔ́	i j ɒ
ìjɔ́l	i j ɒ l
ìjɔ̌	i j ɒ
ìjɛ̀	i j ɛ
ìlàlír	i l ɑ l i ɹ
ìlì	i l i
ìlìŋìnɔ̀	i l i ŋ i n ɒ
ìlí	i l i
ìlŋìnɔ̀	i l ŋ i n ɒ
ìlɔ̀ðɔ̀	i l ɒ ð ɒ
ìlɔ̀ðɔ́	i l ɒ ð ɒ
ìlɔ̀ðɔ̂	i l ɒ ð ɒ
ìlɔ́	i l ɒ
ìlɛ̀ð	i l ɛ ð
ìlɛ́ð	i l ɛ ð
ìlɛ́ðɛ́	i l ɛ ð ɛ
ìmànɛ́n	i m ɑ n ɛ n
ìmàrðén	i m ɑ ɹ ð ɛ n
ìmàrðɛ́n	i m ɑ ɹ ð ɛ n
ìmàðáj	i m ɑ ð ɑ j
ìmàɽðɛ́n	i m ɑ ɹ ð ɛ n
ìmbə̀ɽá	i m b ə ɹ ɑ
ìmbɽá	i m b ɹ ɑ
ìmìdánŋò	i m i d ɑ n ŋ ow
ìmìdánŋwâ	i m i d ɑ n ŋ w ɑ
ìmìdánŋwǒ	i m i d ɑ n ŋ w ow
ìmìdánŋwɔ̀	i m i d ɑ n ŋ w ɒ
ìmìdánŋwɔ̂	i m i d ɑ n ŋ w ɒ
ìmìdánŋwɔ̌	i m i d ɑ n ŋ w ɒ
ìmìdánŋɔ̀	i m i d ɑ n ŋ ɒ
ìmìdánəŋò	i m i d ɑ n ə ŋ ow
ìndò	i n d ow
ìndɔ̀	i n d ɒ
ìndɔ̌	i n d ɒ
ìnd̪ɔ̀	i n d ɒ
ìnd̪ɔ̀t̪ɔ́	i n d ɒ t ɒ
ìnd̪ɔ́t̪ɔ́	i n d ɒ t ɒ
ìngánɔ̂nǎ	i n ɡ ɑ n ɒ n ɑ
ìrcɛ̀cɔ́	i ɹ tʃ ɛ tʃ ɒ
ìrdɛ̀cì	i ɹ d ɛ tʃ i
ìrí	i ɹ i
ìró	i ɹ ow
ìrɔ̀	i ɹ ɒ
ìrɔ́	i ɹ ɒ
ìrɔ́ð	i ɹ ɒ ð
ìt̪ìlɔ̀	i t i l ɒ
ìt̪ìlɔ́	i t i l ɒ
ìt̪ìɾɔ́	i t i ɾ ɒ
ìt̪rɛ́	i t ɹ ɛ
ìt̪ɔ́	i t ɒ
ìt̪ə̀lɔ̀	i t ə l ɒ
ìt̪ə̀lɔ́	i t ə l ɒ
ìt̪ə̀ɾɔ́	i t ə ɾ ɒ
ìt̪ə́và	i t ə v ɑ
ìt̪ə́ɾɛ́	i t ə ɾ ɛ
ìt̪ə́ɾɛ̂	i t ə ɾ ɛ
ìt̪ɾɔ̀	i t ɾ ɒ
ìðí	i ð i
ìðɔ̀ŋ	i ð ɒ ŋ
ìðɔ̀ŋɔ̀	i ð ɒ ŋ ɒ
ìðɔ̀ŋɔ̌	i ð ɒ ŋ ɒ
ìðɔ́	i ð ɒ
ìðə̀ŋgɛ̀j	i ð ə ŋ ɡ ɛ j
ìðɛ̀rɛ̀	i ð ɛ ɹ ɛ
ìðɛ̀ŋgàlʊ̀	i ð ɛ ŋ ɡ ɑ l ʊ
ìðɛ̀ŋgàlʊ́	i ð ɛ ŋ ɡ ɑ l ʊ
ìðɛ̀ŋgɛ́j	i ð ɛ ŋ ɡ ɛ j
ìðɛ̀ŋgɛ́n	i ð ɛ ŋ ɡ ɛ n
ìðɛ̀ŋgɜ̀lí	i ð ɛ ŋ ɡ ɐ l i
ìðɛ̀ŋgɜ̀lír	i ð ɛ ŋ ɡ ɐ l i ɹ
ìŋâvə̀lɛ̀ðà	i ŋ ɑ v ə l ɛ ð ɑ
ìŋgádɔ̀	i ŋ ɡ ɑ d ɒ
ìŋgávə́lɛ̂ðɛ̀	i ŋ ɡ ɑ v ə l ɛ ð ɛ
ìŋgáŋâvə̀lɛ̀ðà	i ŋ ɡ ɑ ŋ ɑ v ə l ɛ ð ɑ
ìŋgɜ̀pìnò	i ŋ ɡ ɐ p i n ow
ìŋnà	i ŋ n ɑ
ìŋná	i ŋ n ɑ
ìŋò	i ŋ ow
ìŋɔ̀	i ŋ ɒ
ìŋɔ̀cìnɔ́	i ŋ ɒ tʃ i n ɒ
ìɲàvə̀lɛ̀ðɛ̀	i ɲ ɑ v ə l ɛ ð ɛ
ìɲárvlɛ̂ðɔ́	i ɲ ɑ ɹ v l ɛ ð ɒ
ìɲávə́lɛ̀ðà	i ɲ ɑ v ə l ɛ ð ɑ
ìɲávə́lɛ̀ðɛ̀	i ɲ ɑ v ə l ɛ ð ɛ
ìɲávə́lɛ̀ðɛ̌	i ɲ ɑ v ə l ɛ ð ɛ
ìɾcɔ̀cɔ̀	i ɾ tʃ ɒ tʃ ɒ
ìɾì	i ɾ i
ìɾìcɔ̀cɔ̀	i ɾ i tʃ ɒ tʃ ɒ
ìɾí	i ɾ i
ìɾɔ́	i ɾ ɒ
í	i
íbjíðɔ̀ndà	i b j i ð ɒ n d ɑ
ídárɛ́j	i d ɑ ɹ ɛ j
ídiíðɔ̀ndà	i d i i ð ɒ n d ɑ
ídì	i d i
ídí	i d i
ídíið	i d i i ð
ídíì	i d i i
ídíí	i d i i
ídíjí	i d i j i
ídíjó	i d i j ow
ídíðə̀ndà	i d i ð ə n d ɑ
ídú	i d ʉ
ídɔ̀	i d ɒ
ídɔ̀t̪ɔ̀	i d ɒ t ɒ
ídɔ̀t̪ɔ́	i d ɒ t ɒ
ídɔ̀ŋt̪á	i d ɒ ŋ t ɑ
ídɔ̀ŋt̪áŋà	i d ɒ ŋ t ɑ ŋ ɑ
ídɔ̀ɽɔ̀	i d ɒ ɹ ɒ
ídɔ́t̪ɔ́	i d ɒ t ɒ
ídɛ̀ɽɔ̀	i d ɛ ɹ ɒ
ídɛ́rɛ́n	i d ɛ ɹ ɛ n
ídɜ̀ɽɔ̀	i d ɐ ɹ ɒ
ídɜ́rálʊ́	i d ɐ ɹ ɑ l ʊ
ídɜ́rɛ́j	i d ɐ ɹ ɛ j
ídɜ́rɛ́n	i d ɐ ɹ ɛ n
ídɜ́rɜ̀lí	i d ɐ ɹ ɐ l i
ídɜ́rɜ̀lír	i d ɐ ɹ ɐ l i ɹ
ídɜ́rɜ̂lír	i d ɐ ɹ ɐ l i ɹ
ídɜ́ɽí	i d ɐ ɹ i
íd́í	i d i
ígánònà	i ɡ ɑ n ow n ɑ
ígáɾàð	i ɡ ɑ ɾ ɑ ð
ígùn	i ɡ ʉ n
ígún	i ɡ ʉ n
ígɔ̀ðɔ́	i ɡ ɒ ð ɒ
ígɔ́	i ɡ ɒ
ígɔ̌	i ɡ ɒ
ígɛ̀ɲí	i ɡ ɛ ɲ i
ígɜ̀ɲí	i ɡ ɐ ɲ i
ígɜ́ɲí	i ɡ ɐ ɲ i
íí	i i
íjà	i j ɑ
íjàló	i j ɑ l ow
íját̪ɔ́	i j ɑ t ɒ
íjé	i j ɛ
íjéðù	i j ɛ ð ʉ
íjì	i j i
íjìbí	i j i b i
íjò	i j ow
íjó	i j ow
íjón	i j ow n
íjô	i j ow
íjǒ	i j ow
íjun	i j ʉ n
íjùn	i j ʉ n
íjú	i j ʉ
íjún	i j ʉ n
íjɔ̀	i j ɒ
íjɔ́	i j ɒ
íjɔ̌	i j ɒ
íjə̀n	i j ə n
íjə́n	i j ə n
íjɛ̀	i j ɛ
íjɛ̀ɲí	i j ɛ ɲ i
íjɛ́n	i j ɛ n
íj̀lír	i j l i ɹ
ílà	i l ɑ
ílì	i l i
ílíjí	i l i j i
ílɔ̀ðɔ̀	i l ɒ ð ɒ
ílɔ́t̪ɔ́	i l ɒ t ɒ
ílɔ́ðɔ́	i l ɒ ð ɒ
ílə̀ðɛ̀	i l ə ð ɛ
ílə̀ðɛ̌	i l ə ð ɛ
ílə̀ɲì	i l ə ɲ i
ílə̀ɲí	i l ə ɲ i
ílɛ̀ðɛ̀	i l ɛ ð ɛ
ílɛ̀ðɛ̌	i l ɛ ð ɛ
ílɛ̀ɲìǐ	i l ɛ ɲ i i
ílɛ́ð	i l ɛ ð
ílɜ́ðɜ́	i l ɐ ð ɐ
ímàðàj	i m ɑ ð ɑ j
ímbɽá	i m b ɹ ɑ
ímìdân	i m i d ɑ n
ímìdǎn	i m i d ɑ n
ímídàn	i m i d ɑ n
ímídân	i m i d ɑ n
índɔ̀	i n d ɒ
índɔ̀ɔ̌	i n d ɒ ɒ
índ̪ɔ́t̪ɔ́	i n d ɒ t ɒ
íngálɔ́ɽà	i n ɡ ɑ l ɒ ɹ ɑ
ínúbà	i n ʉ b ɑ
ínúbá	i n ʉ b ɑ
ínúbǎ	i n ʉ b ɑ
ínɔ̂nɛ̀	i n ɒ n ɛ
ír	i ɹ
írcɔ̀	i ɹ tʃ ɒ
írdɔ̀cɔ̀	i ɹ d ɒ tʃ ɒ
írdɔ́	i ɹ d ɒ
írdɛ̀cí	i ɹ d ɛ tʃ i
írdɜ̀dì	i ɹ d ɐ d i
írí	i ɹ i
íríjɛ́	i ɹ i j ɛ
írlɜ̀ðɜ̀ðì	i ɹ l ɐ ð ɐ ð i
író	i ɹ ow
írún	i ɹ ʉ n
írûn	i ɹ ʉ n
írɔ̀	i ɹ ɒ
írɔ́	i ɹ ɒ
ítí	i t i
ít̪ìmí	i t i m i
ít̪ə́và	i t ə v ɑ
ít̪ə́vɛ̀	i t ə v ɛ
ívə́lɛ̀ðà	i v ə l ɛ ð ɑ
íwɜ̀jnɔ́	i w ɐ j n ɒ
íðùn	i ð ʉ n
íðùŋ	i ð ʉ ŋ
íðún	i ð ʉ n
íðǔŋ	i ð ʉ ŋ
íððì	i ð ð i
íðɔ́	i ð ɒ
íðɔ̂	i ð ɒ
íðʊ́n	i ð ʊ n
íŋ	i ŋ
íŋâvlɛ̀ðɛ̀	i ŋ ɑ v l ɛ ð ɛ
íŋâvlɛ̀ðɛ̌	i ŋ ɑ v l ɛ ð ɛ
íŋganɔ́nà	i ŋ ɡ ɑ n ɒ n ɑ
íŋgaɽə̀ŋàt̪ǎ	i ŋ ɡ ɑ ɹ ə ŋ ɑ t ɑ
íŋgàðɛ́nònà	i ŋ ɡ ɑ ð ɛ n ow n ɑ
íŋgàðɾɔ̂t̪t̪ɔ̀	i ŋ ɡ ɑ ð ɾ ɒ t t ɒ
íŋgàŋâɽìɲà	i ŋ ɡ ɑ ŋ ɑ ɹ i ɲ ɑ
íŋgá	i ŋ ɡ ɑ
íŋgádúrɔ̀	i ŋ ɡ ɑ d ʉ ɹ ɒ
íŋgádúrɔ́	i ŋ ɡ ɑ d ʉ ɹ ɒ
íŋgád̪úrɔ̀	i ŋ ɡ ɑ d ʉ ɹ ɒ
íŋgágârà	i ŋ ɡ ɑ ɡ ɑ ɹ ɑ
íŋgágârá	i ŋ ɡ ɑ ɡ ɑ ɹ ɑ
íŋgájjà	i ŋ ɡ ɑ j j ɑ
íŋgájjínɔ̀	i ŋ ɡ ɑ j j i n ɒ
íŋgáléŋt̪à	i ŋ ɡ ɑ l ɛ ŋ t ɑ
íŋgáléŋə̀t̪à	i ŋ ɡ ɑ l ɛ ŋ ə t ɑ
íŋgálɔ́ɽà	i ŋ ɡ ɑ l ɒ ɹ ɑ
íŋgálɔ́ɾà	i ŋ ɡ ɑ l ɒ ɾ ɑ
íŋgámút̪ɔ̀nà	i ŋ ɡ ɑ m ʉ t ɒ n ɑ
íŋgánà	i ŋ ɡ ɑ n ɑ
íŋgánánà	i ŋ ɡ ɑ n ɑ n ɑ
íŋgánònà	i ŋ ɡ ɑ n ow n ɑ
íŋgánónà	i ŋ ɡ ɑ n ow n ɑ
íŋgánônà	i ŋ ɡ ɑ n ow n ɑ
íŋgánôná	i ŋ ɡ ɑ n ow n ɑ
íŋgánɔ̀nà	i ŋ ɡ ɑ n ɒ n ɑ
íŋgánɔ̀ná	i ŋ ɡ ɑ n ɒ n ɑ
íŋgánɔ́nà	i ŋ ɡ ɑ n ɒ n ɑ
íŋgánɔ̂nà	i ŋ ɡ ɑ n ɒ n ɑ
íŋgárà	i ŋ ɡ ɑ ɹ ɑ
íŋgárnà	i ŋ ɡ ɑ ɹ n ɑ
íŋgárɔ́ðà	i ŋ ɡ ɑ ɹ ɒ ð ɑ
íŋgárɛ́	i ŋ ɡ ɑ ɹ ɛ
íŋgátɔ̀	i ŋ ɡ ɑ t ɒ
íŋgátɛ́və́lɛ̂ðà	i ŋ ɡ ɑ t ɛ v ə l ɛ ð ɑ
íŋgátɛ́və́lɛ̂ðɛ̀	i ŋ ɡ ɑ t ɛ v ə l ɛ ð ɛ
íŋgátɛ́və́lɛ̂ðɛ̌r	i ŋ ɡ ɑ t ɛ v ə l ɛ ð ɛ ɹ
íŋgát̪ɔ̀	i ŋ ɡ ɑ t ɒ
íŋgát̪ə̀vá	i ŋ ɡ ɑ t ə v ɑ
íŋgát̪ə̀vɔ́	i ŋ ɡ ɑ t ə v ɒ
íŋgát̪ə́và	i ŋ ɡ ɑ t ə v ɑ
íŋgát̪ə́vìnɔ̀	i ŋ ɡ ɑ t ə v i n ɒ
íŋgávə́lɛ̀ðà	i ŋ ɡ ɑ v ə l ɛ ð ɑ
íŋgávə́lɛ̂ðɛ̀	i ŋ ɡ ɑ v ə l ɛ ð ɛ
íŋgáw	i ŋ ɡ ɑ w
íŋgáð	i ŋ ɡ ɑ ð
íŋgáðápà	i ŋ ɡ ɑ ð ɑ p ɑ
íŋgáðípɔ̀	i ŋ ɡ ɑ ð i p ɒ
íŋgáðít̪ɔ̀	i ŋ ɡ ɑ ð i t ɒ
íŋgáðíɽòt̪ǎ	i ŋ ɡ ɑ ð i ɹ ow t ɑ
íŋgáðt̪ɔ̀	i ŋ ɡ ɑ ð t ɒ
íŋgáðt̪ɔ̌	i ŋ ɡ ɑ ð t ɒ
íŋgáðúɾú	i ŋ ɡ ɑ ð ʉ ɾ ʉ
íŋgáðə́gɔ̀ðà	i ŋ ɡ ɑ ð ə ɡ ɒ ð ɑ
íŋgáðə́nònnà	i ŋ ɡ ɑ ð ə n ow n n ɑ
íŋgáðə́nònnǎ	i ŋ ɡ ɑ ð ə n ow n n ɑ
íŋgáðə́rɔ̀ðà	i ŋ ɡ ɑ ð ə ɹ ɒ ð ɑ
íŋgáðə́rɔ̀ðǎ	i ŋ ɡ ɑ ð ə ɹ ɒ ð ɑ
íŋgáðə́rɔ̂	i ŋ ɡ ɑ ð ə ɹ ɒ
íŋgáðɛ́gâɾà	i ŋ ɡ ɑ ð ɛ ɡ ɑ ɾ ɑ
íŋgáðɛ́nònà	i ŋ ɡ ɑ ð ɛ n ow n ɑ
íŋgáðɛ́nònǎ	i ŋ ɡ ɑ ð ɛ n ow n ɑ
íŋgáðɛ́nônà	i ŋ ɡ ɑ ð ɛ n ow n ɑ
íŋgáðɾɔ̂ðìt̪ìt̪ɔ̀	i ŋ ɡ ɑ ð ɾ ɒ ð i t i t ɒ
íŋgáðɾɔ̂ðìt̪ìt̪ɔ́	i ŋ ɡ ɑ ð ɾ ɒ ð i t i t ɒ
íŋgáðɾɔ̂ðìt̪ɔ̀	i ŋ ɡ ɑ ð ɾ ɒ ð i t ɒ
íŋgáŋà	i ŋ ɡ ɑ ŋ ɑ
íŋgáŋàɽìɲà	i ŋ ɡ ɑ ŋ ɑ ɹ i ɲ ɑ
íŋgáŋávə̀lɛ̀ðà	i ŋ ɡ ɑ ŋ ɑ v ə l ɛ ð ɑ
íŋgáŋâ	i ŋ ɡ ɑ ŋ ɑ
íŋgáŋâìlɔ̀t̪ɔ̀	i ŋ ɡ ɑ ŋ ɑ i l ɒ t ɒ
íŋgáŋâvlɛ̀dɔ̀	i ŋ ɡ ɑ ŋ ɑ v l ɛ d ɒ
íŋgáŋâvlɛ̀dɔ́	i ŋ ɡ ɑ ŋ ɑ v l ɛ d ɒ
íŋgáŋâvə̀lɛ̀ðà	i ŋ ɡ ɑ ŋ ɑ v ə l ɛ ð ɑ
íŋgáŋâvə̀lɛ̀ðɛ̀	i ŋ ɡ ɑ ŋ ɑ v ə l ɛ ð ɛ
íŋgáŋâvə̀lɛ̀ðɛ̌	i ŋ ɡ ɑ ŋ ɑ v ə l ɛ ð ɛ
íŋgáŋâŋàcà	i ŋ ɡ ɑ ŋ ɑ ŋ ɑ tʃ ɑ
íŋgáŋâŋàcí	i ŋ ɡ ɑ ŋ ɑ ŋ ɑ tʃ i
íŋgáŋâɽìɲà	i ŋ ɡ ɑ ŋ ɑ ɹ i ɲ ɑ
íŋgáŋâɽìɲǎ	i ŋ ɡ ɑ ŋ ɑ ɹ i ɲ ɑ
íŋgáɽìɲɔ̀	i ŋ ɡ ɑ ɹ i ɲ ɒ
íŋgáɽə́ŋàt̪ǎ	i ŋ ɡ ɑ ɹ ə ŋ ɑ t ɑ
íŋgáɾàð	i ŋ ɡ ɑ ɾ ɑ ð
íŋgáɾɔ́ðɛ̀	i ŋ ɡ ɑ ɾ ɒ ð ɛ
íŋgáɾɔ̂t̪t̪ɔ̀	i ŋ ɡ ɑ ɾ ɒ t t ɒ
íŋgâìt̪ɔ̌	i ŋ ɡ ɑ i t ɒ
íŋgâvə̀lɛ̀ðɔ́	i ŋ ɡ ɑ v ə l ɛ ð ɒ
íŋgâŋìcɔ̀	i ŋ ɡ ɑ ŋ i tʃ ɒ
íŋgâŋìcɔ̌	i ŋ ɡ ɑ ŋ i tʃ ɒ
íŋgâɾɔ̀t̪t̪ɔ́	i ŋ ɡ ɑ ɾ ɒ t t ɒ
íŋgó	i ŋ ɡ ow
íŋgóù	i ŋ ɡ ow ʉ
íŋgóẁ	i ŋ ɡ ow w
íŋgɔ́	i ŋ ɡ ɒ
íŋgɔ́rɔ́ðà	i ŋ ɡ ɒ ɹ ɒ ð ɑ
íŋgɔ́t̪ɔ́	i ŋ ɡ ɒ t ɒ
íŋgɔ́ɾɔ́t̪t̪ɛ̀	i ŋ ɡ ɒ ɾ ɒ t t ɛ
íŋgɔ́ɾɔ́ðà	i ŋ ɡ ɒ ɾ ɒ ð ɑ
íŋgɔ́ɾɔ́ðɛ̀	i ŋ ɡ ɒ ɾ ɒ ð ɛ
íŋgɔ́ɾɔ̂t̪t̪ɛ̀	i ŋ ɡ ɒ ɾ ɒ t t ɛ
íŋgɛ́là	i ŋ ɡ ɛ l ɑ
íŋgɛ́lá	i ŋ ɡ ɛ l ɑ
íŋgɛ́lǎ	i ŋ ɡ ɛ l ɑ
íŋgɜ́pínò	i ŋ ɡ ɐ p i n ow
íŋí	i ŋ i
íŋnà	i ŋ n ɑ
íɛ̀nwàj	i ɛ n w ɑ j
íɲà	i ɲ ɑ
íɲá	i ɲ ɑ
íɲún	i ɲ ʉ n
íɲɔ́	i ɲ ɒ
íɲɜ̀ɲì	i ɲ ɐ ɲ i
íɲɜ̀ɲí	i ɲ ɐ ɲ i
íɽàɲìðú	i ɹ ɑ ɲ i ð ʉ
íɾcɛ́cí	i ɾ tʃ ɛ tʃ i
íɾicɔ̀cɔ̀	i ɾ i tʃ ɒ tʃ ɒ
íɾì	i ɾ i
íɾìcɔ̀cɔ̀	i ɾ i tʃ ɒ tʃ ɒ
íɾí	i ɾ i
íɾíjɛ́	i ɾ i j ɛ
íɾò	i ɾ ow
íɾó	i ɾ ow
îjɔ̌	i j ɒ
ǐŋgátə́və́lɛ̂ðɔ́	i ŋ ɡ ɑ t ə v ə l ɛ ð ɒ
ǐŋgátɛ́və́lɛ̂ðɔ́	i ŋ ɡ ɑ t ɛ v ə l ɛ ð ɒ
ǐŋgâvə̀lɛ̀ðɔ́	i ŋ ɡ ɑ v ə l ɛ ð ɒ
jardɛ̀cɔ̀	j ɑ ɹ d ɛ tʃ ɒ
jà	j ɑ
jàbà	j ɑ b ɑ
jàbòt̪ɔ́	j ɑ b ow t ɒ
jàbùðò	j ɑ b ʉ ð ow
jàbùðôĺ	j ɑ b ʉ ð ow l
jàdíjà	j ɑ d i j ɑ
jàdrí	j ɑ d ɹ i
jàdúɾɔ̀	j ɑ d ʉ ɾ ɒ
jàgáɾcìnɛ̀	j ɑ ɡ ɑ ɾ tʃ i n ɛ
jàìt̪ɔ́	j ɑ i t ɒ
jàídíjì	j ɑ i d i j i
jàílɛ̀t̪ɛ̀	j ɑ i l ɛ t ɛ
jàl	j ɑ l
jàlívə́lɛ̂ðɛ̀	j ɑ l i v ə l ɛ ð ɛ
jàlóvə́lɛ̂ðɛ̀	j ɑ l ow v ə l ɛ ð ɛ
jàlvə́lɛ̂ðɛ̀	j ɑ l v ə l ɛ ð ɛ
jàlvə́lɛ̂ðɛ̌	j ɑ l v ə l ɛ ð ɛ
jàlə̀ŋɔ́	j ɑ l ə ŋ ɒ
jàmì	j ɑ m i
jàmìɲí	j ɑ m i ɲ i
jàmɔ̀nɔ́l	j ɑ m ɒ n ɒ l
jàmə̀ɲí	j ɑ m ə ɲ i
jàmə̀ɾðɔ̀	j ɑ m ə ɾ ð ɒ
jàmə̀ɾðɔ́	j ɑ m ə ɾ ð ɒ
jàmɲí	j ɑ m ɲ i
jànt̪ɔ́	j ɑ n t ɒ
jàó	j ɑ ow
jàríbì	j ɑ ɹ i b i
jàrt̪ɔ́	j ɑ ɹ t ɒ
jàrt̪ɔ́lɟí	j ɑ ɹ t ɒ l dʒ i
jàrt̪ɔ́l̀ɟí	j ɑ ɹ t ɒ l dʒ i
jàrt̪ə́lɟí	j ɑ ɹ t ə l dʒ i
jàrɔ́	j ɑ ɹ ɒ
jàt̪ɔ̀	j ɑ t ɒ
jàt̪ɔ́	j ɑ t ɒ
jàúdì	j ɑ ʉ d i
jàvə́lɛ̀ðɛ̀	j ɑ v ə l ɛ ð ɛ
jàvə́lɛ̀ðɛ́	j ɑ v ə l ɛ ð ɛ
jàvə́lɛ̀ðɛ̌	j ɑ v ə l ɛ ð ɛ
jàvə́lɛ̂ðɛ̀	j ɑ v ə l ɛ ð ɛ
jàðábɔ́ðà	j ɑ ð ɑ b ɒ ð ɑ
jàðɔ́jɛ́	j ɑ ð ɒ j ɛ
jàðə́	j ɑ ð ə
jàðɛ́	j ɑ ð ɛ
jàŋàl	j ɑ ŋ ɑ l
jàŋàlà	j ɑ ŋ ɑ l ɑ
jàŋcâíl	j ɑ ŋ tʃ ɑ i l
jàŋcìnɔ́	j ɑ ŋ tʃ i n ɒ
jàŋcí	j ɑ ŋ tʃ i
jàŋìcí	j ɑ ŋ i tʃ i
jàŋnà	j ɑ ŋ n ɑ
jàŋò	j ɑ ŋ ow
jàŋó	j ɑ ŋ ow
jàŋvə́lɛ̂ðɛ̀	j ɑ ŋ v ə l ɛ ð ɛ
jàŋɔ́	j ɑ ŋ ɒ
jàɾt̪ɔ́	j ɑ ɾ t ɒ
jàɾɔ́	j ɑ ɾ ɒ
jàɾɔ́jɛ́	j ɑ ɾ ɒ j ɛ
já	j ɑ
jábòt̪ɛ̀	j ɑ b ow t ɛ
jábótɔ̀	j ɑ b ow t ɒ
jábót̪à	j ɑ b ow t ɑ
jágáɾcìnɔ̀	j ɑ ɡ ɑ ɾ tʃ i n ɒ
jágɔ́t̪ìnɔ̀	j ɑ ɡ ɒ t i n ɒ
jágɔ́t̪ìnɔ̌	j ɑ ɡ ɒ t i n ɒ
jáìdìjé	j ɑ i d i j ɛ
jáídìjɔ̀	j ɑ i d i j ɒ
jáílɔ̀t̪ɔ̀	j ɑ i l ɒ t ɒ
jáít̪ɔ́	j ɑ i t ɒ
jájà	j ɑ j ɑ
jájjínɔ̀	j ɑ j j i n ɒ
jájɛ̀	j ɑ j ɛ
jájɛ́	j ɑ j ɛ
jál	j ɑ l
jáló	j ɑ l ow
jálvə́lɛ̀ðà	j ɑ l v ə l ɛ ð ɑ
jálvə́lɛ̀ðɔ̀	j ɑ l v ə l ɛ ð ɒ
jálə̀ŋɔ́	j ɑ l ə ŋ ɒ
jámìɲí	j ɑ m i ɲ i
jámìɲíl	j ɑ m i ɲ i l
jámlá	j ɑ m l ɑ
jámɔ̀rðɔ́	j ɑ m ɒ ɹ ð ɒ
jánó	j ɑ n ow
jápìjí	j ɑ p i j i
jápíjɔ̀	j ɑ p i j ɒ
jápínɔ̀	j ɑ p i n ɒ
jár	j ɑ ɹ
járà	j ɑ ɹ ɑ
járjɛ̀	j ɑ ɹ j ɛ
járt̪ɔ́	j ɑ ɹ t ɒ
játə́và	j ɑ t ə v ɑ
játɛ́vlɛ̂ðɔ̀	j ɑ t ɛ v l ɛ ð ɒ
játɛ́vlɛ̂ðɔ́	j ɑ t ɛ v l ɛ ð ɒ
játɛ́vlɛ̂ðɔ́r	j ɑ t ɛ v l ɛ ð ɒ ɹ
ját̪ɔ̀	j ɑ t ɒ
ját̪ɔ́	j ɑ t ɒ
ját̪əvà	j ɑ t ə v ɑ
ját̪ə́va	j ɑ t ə v ɑ
ját̪ɛ̀	j ɑ t ɛ
jávà	j ɑ v ɑ
jávə̀lɛ̀ðɔ́	j ɑ v ə l ɛ ð ɒ
jávə̀lɛ̂ðɛ̌	j ɑ v ə l ɛ ð ɛ
jávə́lɛ̀ðà	j ɑ v ə l ɛ ð ɑ
jávə́lɛ̀ðɔ̀	j ɑ v ə l ɛ ð ɒ
jávə́lɛ̂ðà	j ɑ v ə l ɛ ð ɑ
jáðídìjà	j ɑ ð i d i j ɑ
jáðɛ́	j ɑ ð ɛ
jáŋàl	j ɑ ŋ ɑ l
jáŋàlà	j ɑ ŋ ɑ l ɑ
jáŋcìnɔ̀	j ɑ ŋ tʃ i n ɒ
jáŋkə́lcà	j ɑ ŋ k ə l tʃ ɑ
jáŋl	j ɑ ŋ l
jáŋú	j ɑ ŋ ʉ
jáŋǔ	j ɑ ŋ ʉ
jáŋvə́lɛ̂ðà	j ɑ ŋ v ə l ɛ ð ɑ
jáŋvə́lɛ̂ðɔ̀	j ɑ ŋ v ə l ɛ ð ɒ
jáŋə́l	j ɑ ŋ ə l
jáŋʊ́	j ɑ ŋ ʊ
jáɽìŋàt̪ò	j ɑ ɹ i ŋ ɑ t ow
jáɽìŋàt̪ó	j ɑ ɹ i ŋ ɑ t ow
jáɾò	j ɑ ɾ ow
jáɾó	j ɑ ɾ ow
jáɾɔ́jɛ́	j ɑ ɾ ɒ j ɛ
jâbòt̪ɔ́	j ɑ b ow t ɒ
jâdùɾɔ́	j ɑ d ʉ ɾ ɒ
jâgàɾcìnɔ́	j ɑ ɡ ɑ ɾ tʃ i n ɒ
jâj	j ɑ j
jâmìɲí	j ɑ m i ɲ i
jâmìɲíl	j ɑ m i ɲ i l
jâmɔ̀nɔ́l	j ɑ m ɒ n ɒ l
jâpìnjí	j ɑ p i n j i
jârɔ́	j ɑ ɹ ɒ
jât̪ɔ́	j ɑ t ɒ
jâùrú	j ɑ ʉ ɹ ʉ
jâvlɛ̀ðɔ́	j ɑ v l ɛ ð ɒ
jâvtɔ́	j ɑ v t ɒ
jâŋcìnɔ́	j ɑ ŋ tʃ i n ɒ
jâŋò	j ɑ ŋ ow
jâŋó	j ɑ ŋ ow
jâŋú	j ɑ ŋ ʉ
jâŋǔ	j ɑ ŋ ʉ
jâŋɔ́	j ɑ ŋ ɒ
jâɽó	j ɑ ɹ ow
jǎ	j ɑ
jǎjɛ́	j ɑ j ɛ
jǎl	j ɑ l
jǎrà	j ɑ ɹ ɑ
jǎŋ	j ɑ ŋ
jǎŋâvlɛ̀ðɔ́	j ɑ ŋ ɑ v l ɛ ð ɒ
jǎŋcìnɛ̀	j ɑ ŋ tʃ i n ɛ
jǎŋîvlɛ̀ðɔ́	j ɑ ŋ i v l ɛ ð ɒ
jǎŋló	j ɑ ŋ l ow
jǎŋlóvə́lɛ̂ðà	j ɑ ŋ l ow v ə l ɛ ð ɑ
jǎŋlóvə́lɛ̂ðǎ	j ɑ ŋ l ow v ə l ɛ ð ɑ
jècèlò	j ɛ tʃ ɛ l ow
jèrá	j ɛ ɹ ɑ
jèvə̀lɛ̀ðɔ́ló	j ɛ v ə l ɛ ð ɒ l ow
jèðá	j ɛ ð ɑ
jèɽà	j ɛ ɹ ɑ
jèɽò	j ɛ ɹ ow
jé	j ɛ
jékàràt̪ɔ́	j ɛ k ɑ ɹ ɑ t ɒ
jékàrɔ́	j ɛ k ɑ ɹ ɒ
jénúbà	j ɛ n ʉ b ɑ
jéðù	j ɛ ð ʉ
jéðɔ́	j ɛ ð ɒ
jiɽà	j i ɹ ɑ
jìcìlàt̪ó	j i tʃ i l ɑ t ow
jìcìlt̪àt̪ó	j i tʃ i l t ɑ t ow
jìclò	j i tʃ l ow
jìcɔ̀	j i tʃ ɒ
jìcə̀lò	j i tʃ ə l ow
jìdijí	j i d i j i
jìdìjí	j i d i j i
jìgɔ̀t̪ìnɔ́	j i ɡ ɒ t i n ɒ
jìlɔ̀t̪ɔ́	j i l ɒ t ɒ
jìnɔ́	j i n ɒ
jìrvɔ́	j i ɹ v ɒ
jìtàn	j i t ɑ n
jìt̪ɔ́	j i t ɒ
jìɲárvlɛ̂ðɔ́	j i ɲ ɑ ɹ v l ɛ ð ɒ
jìɽà	j i ɹ ɑ
jìɽá	j i ɹ ɑ
jíbɜ̀cí	j i b ɐ tʃ i
jígíɲàt̪ɔ̀	j i ɡ i ɲ ɑ t ɒ
jígíɲàt̪ɔ́	j i ɡ i ɲ ɑ t ɒ
jígíɲɔ́	j i ɡ i ɲ ɒ
jíl	j i l
jílɛŋɔ́	j i l ɛ ŋ ɒ
jínɔ̀nìnɔ́	j i n ɒ n i n ɒ
jínɔ́	j i n ɒ
jít̪ɔ̀	j i t ɒ
jít̪ɔ́	j i t ɒ
jít̪ə̀vìnɔ̀	j i t ə v i n ɒ
jít̪ə̀vìnɔ́	j i t ə v i n ɒ
jít̪ə́và	j i t ə v ɑ
jít̪ə́vɛ̀	j i t ə v ɛ
jít̪ə́vɛ̌	j i t ə v ɛ
jít̪ɛ̀jìnɔ̀	j i t ɛ j i n ɒ
jívə̀lɛ̀ðátɛ̀	j i v ə l ɛ ð ɑ t ɛ
jívə̀lɛ̀ðátɛ́	j i v ə l ɛ ð ɑ t ɛ
jívə̀lɛ̀ðɔ́	j i v ə l ɛ ð ɒ
jívə̀lɜ̀ðìnɔ́	j i v ə l ɐ ð i n ɒ
jíŋàcàcí	j i ŋ ɑ tʃ ɑ tʃ i
jíŋàcìt̪ɔ́	j i ŋ ɑ tʃ i t ɒ
jíŋàcí	j i ŋ ɑ tʃ i
jíŋgávə́lɛ̂ðɛ̌	j i ŋ ɡ ɑ v ə l ɛ ð ɛ
jǐŋgávə́lɛ̂ðɛ̌	j i ŋ ɡ ɑ v ə l ɛ ð ɛ
jò	j ow
jòlà	j ow l ɑ
jòú	j ow ʉ
jónòr	j ow n ow ɹ
jóðɛ̀	j ow ð ɛ
jôɾà	j ow ɾ ɑ
jốsð̀ní	j ow s ð n i
ju	j ʉ
jùpì	j ʉ p i
jùrú	j ʉ ɹ ʉ
jùɽáɾɛ́	j ʉ ɹ ɑ ɾ ɛ
jú	j ʉ
júrmùðɔ́jɛ́	j ʉ ɹ m ʉ ð ɒ j ɛ
jû	j ʉ
jûnd̪òt̪ǔ	j ʉ n d ow t ʉ
jɔ̀là	j ɒ l ɑ
jɔ̀lá	j ɒ l ɑ
jɔ̀ndɔ̀	j ɒ n d ɒ
jɔ̀ɽár	j ɒ ɹ ɑ ɹ
jɔ̀ɽárɛ̀	j ɒ ɹ ɑ ɹ ɛ
jɔ̀ɽɛ̀	j ɒ ɹ ɛ
jɔ́	j ɒ
jɔ́ɾà	j ɒ ɾ ɑ
jɔ̂rnɔ́	j ɒ ɹ n ɒ
jɔ̂ɽɟɛ̀cáŋà	j ɒ ɹ dʒ ɛ tʃ ɑ ŋ ɑ
jərâu	j ə ɹ ɑ ʉ
jə̀cə̀lò	j ə tʃ ə l ow
jə̀drí	j ə d ɹ i
jə̀gàràt̪ɔ́	j ə ɡ ɑ ɹ ɑ t ɒ
jə̀râu	j ə ɹ ɑ ʉ
jə̀râw	j ə ɹ ɑ w
jə̀rt̪ɔ́	j ə ɹ t ɒ
jə̀t̪ə̀vá	j ə t ə v ɑ
jə̀vlɛ̀ðɔ́	j ə v l ɛ ð ɒ
jə̀vlɛ̀ðɔ́lŋó	j ə v l ɛ ð ɒ l ŋ ow
jə̀və̀lɛ̀ðɔ́	j ə v ə l ɛ ð ɒ
jə̀və̀lɛ̀ðɔ́l	j ə v ə l ɛ ð ɒ l
jə̀və̀lɛ̀ðɔ́lŋó	j ə v ə l ɛ ð ɒ l ŋ ow
jə̀və̀lɛ̀ðɔ́lɔ́ŋʊ	j ə v ə l ɛ ð ɒ l ɒ ŋ ʊ
jə̀və̀lɛ̀ðɔ́lɔ́ŋʊ̀	j ə v ə l ɛ ð ɒ l ɒ ŋ ʊ
jə̀və̀lɛ̀ðɔ́lə́ŋò	j ə v ə l ɛ ð ɒ l ə ŋ ow
jə̀və̀lɛ̀ðɔ́lə́ŋó	j ə v ə l ɛ ð ɒ l ə ŋ ow
jə̀və̀lɛ̀ðɔ́ŋ	j ə v ə l ɛ ð ɒ ŋ
jə̀vɛ̀lɛ̀ðɔ́	j ə v ɛ l ɛ ð ɒ
jə̀ŋàcí	j ə ŋ ɑ tʃ i
jə̀ɾâu	j ə ɾ ɑ ʉ
jə́	j ə
jə́rdɔ́	j ə ɹ d ɒ
jə́ɾàu	j ə ɾ ɑ ʉ
jɛéà	j ɛ ɛ ɑ
jɛ̀	j ɛ
jɛ̀clò	j ɛ tʃ l ow
jɛ̀cə̀lò	j ɛ tʃ ə l ow
jɛ̀cə̀lǒ	j ɛ tʃ ə l ow
jɛ̀dìjí	j ɛ d i j i
jɛ̀dí	j ɛ d i
jɛ̀gàrɔ́	j ɛ ɡ ɑ ɹ ɒ
jɛ̀gàɾcìnɔ́	j ɛ ɡ ɑ ɾ tʃ i n ɒ
jɛ̀gáɾàt̪ɔ́	j ɛ ɡ ɑ ɾ ɑ t ɒ
jɛ̀ìdìjé	j ɛ i d i j ɛ
jɛ̀lírvə́lɛ̂ðɛ̌rló	j ɛ l i ɹ v ə l ɛ ð ɛ ɹ l ow
jɛ̀lívə́lɛ̂ðɛ̀	j ɛ l i v ə l ɛ ð ɛ
jɛ̀lívə́lɛ̂ðɛ̌	j ɛ l i v ə l ɛ ð ɛ
jɛ̀lə̀ŋà	j ɛ l ə ŋ ɑ
jɛ̀rcɜ̀cí	j ɛ ɹ tʃ ɐ tʃ i
jɛ̀rdɔ́	j ɛ ɹ d ɒ
jɛ̀rd̪ɔ́	j ɛ ɹ d ɒ
jɛ̀rlɜ̀nd̪ìnɔ̀	j ɛ ɹ l ɐ n d i n ɒ
jɛ̀rlɜ̀nd̪ìnɔ́	j ɛ ɹ l ɐ n d i n ɒ
jɛ̀rnà	j ɛ ɹ n ɑ
jɛ̀rnɔ́	j ɛ ɹ n ɒ
jɛ̀rɔ́	j ɛ ɹ ɒ
jɛ̀tàn	j ɛ t ɑ n
jɛ̀tàɾànà	j ɛ t ɑ ɾ ɑ n ɑ
jɛ̀vlɛ̀cí	j ɛ v l ɛ tʃ i
jɛ̀və̀lɛ̀ðà	j ɛ v ə l ɛ ð ɑ
jɛ̀ðɔ́l	j ɛ ð ɒ l
jɛ̀ðə̀ŋná	j ɛ ð ə ŋ n ɑ
jɛ̀ðə̀ŋnánó	j ɛ ð ə ŋ n ɑ n ow
jɛ̀ðə̀ŋǹánó	j ɛ ð ə ŋ n ɑ n ow
jɛ̀ɽ	j ɛ ɹ
jɛ̀ɽcàn	j ɛ ɹ tʃ ɑ n
jɛ̀ɽcǎn	j ɛ ɹ tʃ ɑ n
jɛ̀ɽicàn	j ɛ ɹ i tʃ ɑ n
jɛ̀ɽìɲɔ́	j ɛ ɹ i ɲ ɒ
jɛ̀ɽò	j ɛ ɹ ow
jɛ́	j ɛ
jɛ́dɔ́	j ɛ d ɒ
jɛ́gàɾàt̪ɔ́	j ɛ ɡ ɑ ɾ ɑ t ɒ
jɛ́gàɾìt̪ɔ́	j ɛ ɡ ɑ ɾ i t ɒ
jɛ́gàɾɔ́	j ɛ ɡ ɑ ɾ ɒ
jɛ́gwɔ̀t̪ɔ́	j ɛ ɡ w ɒ t ɒ
jɛ́l	j ɛ l
jɛ́lvə́lɛ̂ðà	j ɛ l v ə l ɛ ð ɑ
jɛ́lvə́lɛ̂ðàl	j ɛ l v ə l ɛ ð ɑ l
jɛ́lvə́lɛ̂ðàlo	j ɛ l v ə l ɛ ð ɑ l ow
jɛ́lvə́lɛ̂ðàló	j ɛ l v ə l ɛ ð ɑ l ow
jɛ́lə̀vcàcí	j ɛ l ə v tʃ ɑ tʃ i
jɛ́lə̀vcí	j ɛ l ə v tʃ i
jɛ́lɛ̀və̀cìt̪ɔ́	j ɛ l ɛ v ə tʃ i t ɒ
jɛ́nɔ̀nìnɔ́	j ɛ n ɒ n i n ɒ
jɛ́rlɛ̀ŋí	j ɛ ɹ l ɛ ŋ i
jɛ́rlɛ̀ɲí	j ɛ ɹ l ɛ ɲ i
jɛ́r̀lɛ̀nd̪ìnɔ́	j ɛ ɹ l ɛ n d i n ɒ
jɛ́ŕlɛ̀nd̪ìnɔ̀	j ɛ ɹ l ɛ n d i n ɒ
jɛ́ŕlɛ̀nd̪ìnɔ́	j ɛ ɹ l ɛ n d i n ɒ
jɛ́ûrmùðɔ̀	j ɛ ʉ ɹ m ʉ ð ɒ
jɛ́vlɛ̀cìt̪ɔ́	j ɛ v l ɛ tʃ i t ɒ
jɛ́vlɛ̀cɜ̀cí	j ɛ v l ɛ tʃ ɐ tʃ i
jɛ́vəlɛ̀ðáŋà	j ɛ v ə l ɛ ð ɑ ŋ ɑ
jɛ́və̀lɛ̀ðátɛ́	j ɛ v ə l ɛ ð ɑ t ɛ
jɛ́və̀lɛ̀ðáŋà	j ɛ v ə l ɛ ð ɑ ŋ ɑ
jɛ́və̀lɛ̀ðìnɔ́	j ɛ v ə l ɛ ð i n ɒ
jɛ́wàjí	j ɛ w ɑ j i
jɛ́wɜ̀jnɔ́	j ɛ w ɐ j n ɒ
jɛ́ðùɽú	j ɛ ð ʉ ɹ ʉ
jɛ́ŋáǒ	j ɛ ŋ ɑ ow
jɛ́ŋgìð	j ɛ ŋ ɡ i ð
jɛ́ŋgɛ́n	j ɛ ŋ ɡ ɛ n
jɛ́ɾɔ̀t̪t̪ɔ́	j ɛ ɾ ɒ t t ɒ
jɛ́ɾɔ̀ðìt̪ɔ́	j ɛ ɾ ɒ ð i t ɒ
jɛ́ɾɔ̀ðɔ́	j ɛ ɾ ɒ ð ɒ
jɛ́ɾɔ̀ðɜ̀ìt̪ɔ́	j ɛ ɾ ɒ ð ɐ i t ɒ
jɛ̂	j ɛ
jɛ̂t̪ɔ́	j ɛ t ɒ
jɛ̌lɛ̀ŋɛ̀t̪ɔ́	j ɛ l ɛ ŋ ɛ t ɒ
jɜ̀dí	j ɐ d i
jɜ̀ŋci	j ɐ ŋ tʃ i
jɜ̀ŋcí	j ɐ ŋ tʃ i
jɜ̀ŋcɜ̀cí	j ɐ ŋ tʃ ɐ tʃ i
jɜ́ùrmùðɔ̀	j ɐ ʉ ɹ m ʉ ð ɒ
jɜ́ŋcɜ́cì	j ɐ ŋ tʃ ɐ tʃ i
jɜ̂ŋcí	j ɐ ŋ tʃ i
jɜ̂ŋcɜ̀cí	j ɐ ŋ tʃ ɐ tʃ i
jɜ̌ŋcɔ́cɔ̀	j ɐ ŋ tʃ ɒ tʃ ɒ
k	k
ka	k ɑ
kadam	k ɑ d ɑ m
kalɛrɛr	k ɑ l ɛ ɹ ɛ ɹ
kamáðjt̪ɛ̀	k ɑ m ɑ ð j t ɛ
kanð	k ɑ n ð
kauda	k ɑ ʉ d ɑ
kaŋɔnɔna	k ɑ ŋ ɒ n ɒ n ɑ
kà	k ɑ
kàbàɽà	k ɑ b ɑ ɹ ɑ
kàbúlíjɛ̀cì	k ɑ b ʉ l i j ɛ tʃ i
kàdɔ̀ŋnɔ́	k ɑ d ɒ ŋ n ɒ
kàdɔ̀ŋðɔ́	k ɑ d ɒ ŋ ð ɒ
kàdɔ́ŋðàt̪ɛ̀	k ɑ d ɒ ŋ ð ɑ t ɛ
kàdɔ́ŋðɛ̀	k ɑ d ɒ ŋ ð ɛ
kàdɔ́ŋðɛ̌	k ɑ d ɒ ŋ ð ɛ
kàgáɾíjì	k ɑ ɡ ɑ ɾ i j i
kàgáɾíðì	k ɑ ɡ ɑ ɾ i ð i
kàgít̪ɛ̀	k ɑ ɡ i t ɛ
kàgíðìt̪ɛ̀	k ɑ ɡ i ð i t ɛ
kàgíðɛ́t̪ɛ̀	k ɑ ɡ i ð ɛ t ɛ
kàgɔ́t̪íjì	k ɑ ɡ ɒ t i j i
kàgə́cíðì	k ɑ ɡ ə tʃ i ð i
kàgɛ́	k ɑ ɡ ɛ
kàgɛ́ɲát̪ɛ̀	k ɑ ɡ ɛ ɲ ɑ t ɛ
kàídì	k ɑ i d i
kàídɛ́t̪ɛ̀	k ɑ i d ɛ t ɛ
kàíjɛ̀	k ɑ i j ɛ
kàjɛ́nìjì	k ɑ j ɛ n i j i
kàjɛ́nìjìǐ	k ɑ j ɛ n i j i i
kàkà	k ɑ k ɑ
kàkáɾcàcì	k ɑ k ɑ ɾ tʃ ɑ tʃ i
kàkáɾcìðì	k ɑ k ɑ ɾ tʃ i ð i
kàkáɾcíðàt̪ɛ̀	k ɑ k ɑ ɾ tʃ i ð ɑ t ɛ
kàkáɾcíðì	k ɑ k ɑ ɾ tʃ i ð i
kàkə̀cí	k ɑ k ə tʃ i
kàkə́cì	k ɑ k ə tʃ i
kàkɛ́cì	k ɑ k ɛ tʃ i
kàkɛ́cɛ́cì	k ɑ k ɛ tʃ ɛ tʃ i
kàllɛ́rɛ́r	k ɑ l l ɛ ɹ ɛ ɹ
kàmáðɛ̀t̪ɛ̀	k ɑ m ɑ ð ɛ t ɛ
kàmìɲí	k ɑ m i ɲ i
kàmùt̪èná	k ɑ m ʉ t ɛ n ɑ
kàmùt̪ɔ̀ná	k ɑ m ʉ t ɒ n ɑ
kàmùt̪ɔ̀náŋà	k ɑ m ʉ t ɒ n ɑ ŋ ɑ
kàmùt̪ɔ́	k ɑ m ʉ t ɒ
kàmùt̪ɛ̀	k ɑ m ʉ t ɛ
kàmùt̪̀	k ɑ m ʉ t
kàmɔ̀rðɔ́	k ɑ m ɒ ɹ ð ɒ
kàmɔ̀ŋnɔ́	k ɑ m ɒ ŋ n ɒ
kàmɔ̀ŋt̪ɔ́	k ɑ m ɒ ŋ t ɒ
kàmə̀ɾðɔ́	k ɑ m ə ɾ ð ɒ
kàmə̀ɾðɔ́gɛ́	k ɑ m ə ɾ ð ɒ ɡ ɛ
kàmə̀ɾðɔ́t̪ɔ́l	k ɑ m ə ɾ ð ɒ t ɒ l
kàn	k ɑ n
kàndíjì	k ɑ n d i j i
kàpàt̪ɔ́	k ɑ p ɑ t ɒ
kàpìt̪ɔ́	k ɑ p i t ɒ
kàpìðú	k ɑ p i ð ʉ
kàpɔ́	k ɑ p ɒ
kàrcá	k ɑ ɹ tʃ ɑ
kàrè	k ɑ ɹ ɛ
kàré	k ɑ ɹ ɛ
kàró	k ɑ ɹ ow
kàrt̪ìnáidí	k ɑ ɹ t i n ɑ i d i
kàrt̪ìnɔ́	k ɑ ɹ t i n ɒ
kàrt̪íŋì	k ɑ ɹ t i ŋ i
kàrt̪íŋǐ	k ɑ ɹ t i ŋ i
kàrt̪îŋì	k ɑ ɹ t i ŋ i
kàrt̪îŋǐ	k ɑ ɹ t i ŋ i
kàrt̪ɔ́	k ɑ ɹ t ɒ
kàrt̪ɔ́l	k ɑ ɹ t ɒ l
kàrɔ̀	k ɑ ɹ ɒ
kàrɔ́	k ɑ ɹ ɒ
kàrɔ́gɛ́	k ɑ ɹ ɒ ɡ ɛ
kàrɛ́	k ɑ ɹ ɛ
kàŕlànd̪á	k ɑ ɹ l ɑ n d ɑ
kàtóðì	k ɑ t ow ð i
kàtúðìjì	k ɑ t ʉ ð i j i
kàtúðìjìǐ	k ɑ t ʉ ð i j i i
kàtɛ́nɔ̂nǎr	k ɑ t ɛ n ɒ n ɑ ɹ
kàtɛ́və́lɛ̂ðɛ̀	k ɑ t ɛ v ə l ɛ ð ɛ
kàtɛ́və́lɛ̂ðɛ̌r	k ɑ t ɛ v ə l ɛ ð ɛ ɹ
kàt̪ét̪è	k ɑ t ɛ t ɛ
kàt̪íjè	k ɑ t i j ɛ
kàt̪íjì	k ɑ t i j i
kàt̪íðì	k ɑ t i ð i
kàt̪ɔ́t̪ɛ̀	k ɑ t ɒ t ɛ
kàt̪ɛ́t̪ɛ̀	k ɑ t ɛ t ɛ
kàúríjì	k ɑ ʉ ɹ i j i
kàútíðìjì	k ɑ ʉ t i ð i j i
kàútíðìðì	k ɑ ʉ t i ð i ð i
kàúɽcíjì	k ɑ ʉ ɹ tʃ i j i
kàúɽðìjì	k ɑ ʉ ɹ ð i j i
kàúɽðíjì	k ɑ ʉ ɹ ð i j i
kàvə̀lɛ̂ðɛ̀	k ɑ v ə l ɛ ð ɛ
kàvə́lɛ̀ðɛ̀	k ɑ v ə l ɛ ð ɛ
kàvə́lɛ̂ðɛ̀	k ɑ v ə l ɛ ð ɛ
kàvə́rlɛ̀ðɔ́	k ɑ v ə ɹ l ɛ ð ɒ
kàvə́rðɛ̀	k ɑ v ə ɹ ð ɛ
kàvɛ̀lɛ̀ðɔ́	k ɑ v ɛ l ɛ ð ɒ
kàðádɔ̀ŋnɔ̀	k ɑ ð ɑ d ɒ ŋ n ɒ
kàðát̪ɛ̀	k ɑ ð ɑ t ɛ
kàððàt̪ɔ́l	k ɑ ð ð ɑ t ɒ l
kàððɔ́gɛ́	k ɑ ð ð ɒ ɡ ɛ
kàðə̀nɔ́nà	k ɑ ð ə n ɒ n ɑ
kàðə́gə̀lcà	k ɑ ð ə ɡ ə l tʃ ɑ
kàðə́kə̀lcà	k ɑ ð ə k ə l tʃ ɑ
kàðə́kə̂lcà	k ɑ ð ə k ə l tʃ ɑ
kàðə́kə̂lcǎ	k ɑ ð ə k ə l tʃ ɑ
kàðə́nɔ̀nà	k ɑ ð ə n ɒ n ɑ
kàðə́nɔ̂nà	k ɑ ð ə n ɒ n ɑ
kàðə́vr̀lɛ̀ðó	k ɑ ð ə v ɹ l ɛ ð ow
kàðə́vr̀lɛ̀ðɔ́	k ɑ ð ə v ɹ l ɛ ð ɒ
kàðə́və̀lɛ̀ðàt̪ó	k ɑ ð ə v ə l ɛ ð ɑ t ow
kàðə́və̀rlɛ̀ðàt̪ó	k ɑ ð ə v ə ɹ l ɛ ð ɑ t ow
kàðə́və̀rlɛ̀ðó	k ɑ ð ə v ə ɹ l ɛ ð ow
kàðə́və̀rlɛ̀ðɔ́	k ɑ ð ə v ə ɹ l ɛ ð ɒ
kàðə́və́lêðà	k ɑ ð ə v ə l ɛ ð ɑ
kàðə́və́lɛ̂ðà	k ɑ ð ə v ə l ɛ ð ɑ
kàðɛ́və̀lèðà	k ɑ ð ɛ v ə l ɛ ð ɑ
kàðɛ́və̀lèðɔ́	k ɑ ð ɛ v ə l ɛ ð ɒ
kàðɛ́və́lêðà	k ɑ ð ɛ v ə l ɛ ð ɑ
kàðɛ́ðì	k ɑ ð ɛ ð i
kàðɛ́ŋɛ́n	k ɑ ð ɛ ŋ ɛ n
kàðɛ́ŋɛ́nɛ́	k ɑ ð ɛ ŋ ɛ n ɛ
kàŋ	k ɑ ŋ
kàŋátɛ̀	k ɑ ŋ ɑ t ɛ
kàŋátɛ́	k ɑ ŋ ɑ t ɛ
kàŋátɛ́r	k ɑ ŋ ɑ t ɛ ɹ
kàŋáŋà	k ɑ ŋ ɑ ŋ ɑ
kàŋâ	k ɑ ŋ ɑ
kàŋâvlɛ̀ðɛ̀	k ɑ ŋ ɑ v l ɛ ð ɛ
kàŋcáŋà	k ɑ ŋ tʃ ɑ ŋ ɑ
kàŋcáŋǎ	k ɑ ŋ tʃ ɑ ŋ ɑ
kàŋcìnìjí	k ɑ ŋ tʃ i n i j i
kàŋcìnɔ́	k ɑ ŋ tʃ i n ɒ
kàŋcí	k ɑ ŋ tʃ i
kàŋcíŋì	k ɑ ŋ tʃ i ŋ i
kàŋcíŋǐ	k ɑ ŋ tʃ i ŋ i
kàŋcî	k ɑ ŋ tʃ i
kàŋcîí	k ɑ ŋ tʃ i i
kàŋínɔ̀nà	k ɑ ŋ i n ɒ n ɑ
kàŋíŋì	k ɑ ŋ i ŋ i
kàŋíŋî	k ɑ ŋ i ŋ i
kàŋíɲárɛ́	k ɑ ŋ i ɲ ɑ ɹ ɛ
kàŋî	k ɑ ŋ i
kàŋîvə̀lɛ̀ðɛ̀	k ɑ ŋ i v ə l ɛ ð ɛ
kàŋîŋì	k ɑ ŋ i ŋ i
kàŋǒŋ	k ɑ ŋ ow ŋ
kàŋt̪ɔ́	k ɑ ŋ t ɒ
kàŋú	k ɑ ŋ ʉ
kàŋvə́lɛ̂ðɛ̀	k ɑ ŋ v ə l ɛ ð ɛ
kàŋvə́lɛ̂ðɛ̌	k ɑ ŋ v ə l ɛ ð ɛ
kàŋɔ́	k ɑ ŋ ɒ
kàŋɔ̂	k ɑ ŋ ɒ
kàŋʊ́	k ɑ ŋ ʊ
kàɔ́ɽɟɛ̀cì	k ɑ ɒ ɹ dʒ ɛ tʃ i
kàɽìɲáɲàgɛ̌	k ɑ ɹ i ɲ ɑ ɲ ɑ ɡ ɛ
kàɽŋàt̪ó	k ɑ ɹ ŋ ɑ t ow
kàɽə̀ŋàt̪ó	k ɑ ɹ ə ŋ ɑ t ow
kàɽə̀ŋàt̪ǒ	k ɑ ɹ ə ŋ ɑ t ow
kàɾàt̪á	k ɑ ɾ ɑ t ɑ
kàɾì	k ɑ ɾ i
kàɾí	k ɑ ɾ i
kàɾó	k ɑ ɾ ow
kàɾt̪ɔ́	k ɑ ɾ t ɒ
kàɾt̪ɔ́l	k ɑ ɾ t ɒ l
kàɾt̪ɔ̂l	k ɑ ɾ t ɒ l
kàɾú	k ɑ ɾ ʉ
kàɾúŋì	k ɑ ɾ ʉ ŋ i
kàɾúŋî	k ɑ ɾ ʉ ŋ i
kàɾúŋə̀t̪ɛ̀	k ɑ ɾ ʉ ŋ ə t ɛ
kàɾɔ́	k ɑ ɾ ɒ
kàɾɔ́gɛ́	k ɑ ɾ ɒ ɡ ɛ
kàɾə́ŋî	k ɑ ɾ ə ŋ i
ká	k ɑ
kábà	k ɑ b ɑ
kábá	k ɑ b ɑ
káblàt̪à	k ɑ b l ɑ t ɑ
kábùlìjɛ̀cí	k ɑ b ʉ l i j ɛ tʃ i
kábúlìjɔ̀cɔ̀	k ɑ b ʉ l i j ɒ tʃ ɒ
kábɾì	k ɑ b ɾ i
káb̀làt̪à	k ɑ b l ɑ t ɑ
kácí	k ɑ tʃ i
kádàm	k ɑ d ɑ m
kádám	k ɑ d ɑ m
kádɔ̀ŋnɛ̀	k ɑ d ɒ ŋ n ɛ
kádɔ̀ŋðɔ́	k ɑ d ɒ ŋ ð ɒ
kádɔ́ŋðà	k ɑ d ɒ ŋ ð ɑ
kádɔ́ŋðɔ̀	k ɑ d ɒ ŋ ð ɒ
kádɔ́ŋðɛ̀	k ɑ d ɒ ŋ ð ɛ
kágàɾìjí	k ɑ ɡ ɑ ɾ i j i
kágáɾà	k ɑ ɡ ɑ ɾ ɑ
kágáɾàt̪à	k ɑ ɡ ɑ ɾ ɑ t ɑ
kágáɾìðà	k ɑ ɡ ɑ ɾ i ð ɑ
kágáɾíjɔ̀	k ɑ ɡ ɑ ɾ i j ɒ
kágìðɔ̀t̪ɔ́	k ɑ ɡ i ð ɒ t ɒ
kágít̪ɔ̀	k ɑ ɡ i t ɒ
kágíðɔ̀t̪ɔ̀	k ɑ ɡ i ð ɒ t ɒ
kágɔ̀t̪ìjí	k ɑ ɡ ɒ t i j i
kágɔ́t̪ìjɔ̀	k ɑ ɡ ɒ t i j ɒ
kágə́cìðɔ̀	k ɑ ɡ ə tʃ i ð ɒ
kágɛ̀ɲàt̪ɔ́	k ɑ ɡ ɛ ɲ ɑ t ɒ
kágɛ́	k ɑ ɡ ɛ
kágɛ́ɲàt̪à	k ɑ ɡ ɛ ɲ ɑ t ɑ
káì	k ɑ i
káìdɔ̀t̪ɔ́	k ɑ i d ɒ t ɒ
kájàt̪à	k ɑ j ɑ t ɑ
káját̪à	k ɑ j ɑ t ɑ
kájínìjɔ̀	k ɑ j i n i j ɒ
kájínɔ́	k ɑ j i n ɒ
kájít̪ɔ̀	k ɑ j i t ɒ
kájjɔ̀	k ɑ j j ɒ
kájt̪ìŋì	k ɑ j t i ŋ i
kájɔ̀	k ɑ j ɒ
kájɛ̀n	k ɑ j ɛ n
kájɛ́nìjɔ̀	k ɑ j ɛ n i j ɒ
kák	k ɑ k
káka	k ɑ k ɑ
kákà	k ɑ k ɑ
kákàgɛ̀	k ɑ k ɑ ɡ ɛ
kákàrì	k ɑ k ɑ ɹ i
kákàŋ	k ɑ k ɑ ŋ
kákàŋù	k ɑ k ɑ ŋ ʉ
kákàŋú	k ɑ k ɑ ŋ ʉ
kákàŋúðàr	k ɑ k ɑ ŋ ʉ ð ɑ ɹ
kákàŋúðár	k ɑ k ɑ ŋ ʉ ð ɑ ɹ
kákàŋúðɛ̀r	k ɑ k ɑ ŋ ʉ ð ɛ ɹ
kákàɾcàcí	k ɑ k ɑ ɾ tʃ ɑ tʃ i
kákàɾcìðàt̪ɔ́	k ɑ k ɑ ɾ tʃ i ð ɑ t ɒ
kákàɾcìðú	k ɑ k ɑ ɾ tʃ i ð ʉ
kákàɾìðú	k ɑ k ɑ ɾ i ð ʉ
káká	k ɑ k ɑ
kákáɾcácà	k ɑ k ɑ ɾ tʃ ɑ tʃ ɑ
kákáɾcíðà	k ɑ k ɑ ɾ tʃ i ð ɑ
kákáɾcíðàt̪à	k ɑ k ɑ ɾ tʃ i ð ɑ t ɑ
kákáɾìðàǎ	k ɑ k ɑ ɾ i ð ɑ ɑ
kákǎŋ	k ɑ k ɑ ŋ
kákɔ́cɔ̀	k ɑ k ɒ tʃ ɒ
kákɔ́cɔ̀cɔ̀	k ɑ k ɒ tʃ ɒ tʃ ɒ
kákə̀cí	k ɑ k ə tʃ i
kákə̀cɛ̀cí	k ɑ k ə tʃ ɛ tʃ i
kákə̀lcí	k ɑ k ə l tʃ i
kákə́cì	k ɑ k ə tʃ i
kákə́lcà	k ɑ k ə l tʃ ɑ
kákɛ̀cɛ̀cí	k ɑ k ɛ tʃ ɛ tʃ i
kákɛ́cɛ́cì	k ɑ k ɛ tʃ ɛ tʃ i
kál	k ɑ l
kálàbðà	k ɑ l ɑ b ð ɑ
kálgɛ́rɛ́	k ɑ l ɡ ɛ ɹ ɛ
kálìjà	k ɑ l i j ɑ
kállɛ̀rɛ̀	k ɑ l l ɛ ɹ ɛ
kálú	k ɑ l ʉ
kálvə̀lɛ̀ðɔ́	k ɑ l v ə l ɛ ð ɒ
kálvə̀lɛ̀ðɛ̀	k ɑ l v ə l ɛ ð ɛ
kálvə̀lɛ̀ðɛ́l	k ɑ l v ə l ɛ ð ɛ l
kálvə̀lɛ̀ðɛ̌	k ɑ l v ə l ɛ ð ɛ
kálvə́lɛ̀ðà	k ɑ l v ə l ɛ ð ɑ
kálvə́lɛ̀ðɛ̀l	k ɑ l v ə l ɛ ð ɛ l
kálðíɾín	k ɑ l ð i ɾ i n
kálɔ̀ŋɔ́	k ɑ l ɒ ŋ ɒ
kálɔ́ŋú	k ɑ l ɒ ŋ ʉ
kálə̀ŋɔ́	k ɑ l ə ŋ ɒ
kálɛ̀rɛ̀	k ɑ l ɛ ɹ ɛ
kám	k ɑ m
kámàðìt̪	k ɑ m ɑ ð i t
kámàðìt̪ɔ́	k ɑ m ɑ ð i t ɒ
kámàɽà	k ɑ m ɑ ɹ ɑ
kámàɽàŋà	k ɑ m ɑ ɹ ɑ ŋ ɑ
kámàɽàŋá	k ɑ m ɑ ɹ ɑ ŋ ɑ
kámàɽàŋú	k ɑ m ɑ ɹ ɑ ŋ ʉ
kámàɽàŋɾɛ́	k ɑ m ɑ ɹ ɑ ŋ ɾ ɛ
kámáðìt̪ɔ̀	k ɑ m ɑ ð i t ɒ
kámáðít̪ɔ̀	k ɑ m ɑ ð i t ɒ
kámáɽá	k ɑ m ɑ ɹ ɑ
kámáɽáŋá	k ɑ m ɑ ɹ ɑ ŋ ɑ
kámìɲàcí	k ɑ m i ɲ ɑ tʃ i
kámìɲí	k ɑ m i ɲ i
kámìɲɔ̀t̪ɔ́	k ɑ m i ɲ ɒ t ɒ
kámìɲɔ́	k ɑ m i ɲ ɒ
kámíɲàt̪à	k ɑ m i ɲ ɑ t ɑ
kámðáŋɾa	k ɑ m ð ɑ ŋ ɾ ɑ
kámðɛ́ŋǎ	k ɑ m ð ɛ ŋ ɑ
kámə̀ɾðɔ́	k ɑ m ə ɾ ð ɒ
kámɛ̀ðìt̪ɔ̀	k ɑ m ɛ ð i t ɒ
kán	k ɑ n
kándáŋèlà	k ɑ n d ɑ ŋ ɛ l ɑ
kándíjɔ̀	k ɑ n d i j ɒ
kánðá	k ɑ n ð ɑ
kánɔ̂na	k ɑ n ɒ n ɑ
kánɔ̂nà	k ɑ n ɒ n ɑ
kánɛ́	k ɑ n ɛ
káǹíŋâiɲɔ́	k ɑ n i ŋ ɑ i ɲ ɒ
káń	k ɑ n
káó	k ɑ ow
kápà	k ɑ p ɑ
kápátɛ̀	k ɑ p ɑ t ɛ
kápát̪à	k ɑ p ɑ t ɑ
kápát̪ɛ̀	k ɑ p ɑ t ɛ
kápít̪ìt̪ɛ̀	k ɑ p i t i t ɛ
kápít̪ɔ̀	k ɑ p i t ɒ
kápít̪ɛ̀	k ɑ p i t ɛ
kápíðì	k ɑ p i ð i
kápíðə̀t̪ɛ̀	k ɑ p i ð ə t ɛ
kápɔ̀	k ɑ p ɒ
kápə́t̪ɛ̀	k ɑ p ə t ɛ
kápɛ̀	k ɑ p ɛ
kápɛ́t̪ɛ̀	k ɑ p ɛ t ɛ
kápɜ́ìt̪ɛ̀	k ɑ p ɐ i t ɛ
kárcí	k ɑ ɹ tʃ i
kárè	k ɑ ɹ ɛ
káré	k ɑ ɹ ɛ
kárgɛ́	k ɑ ɹ ɡ ɛ
kári	k ɑ ɹ i
kárì	k ɑ ɹ i
kárkàrɛ̀	k ɑ ɹ k ɑ ɹ ɛ
kárlɔ̀ŋí	k ɑ ɹ l ɒ ŋ i
kárlɔ̀ŋɔ̀	k ɑ ɹ l ɒ ŋ ɒ
kárlə̀ɲɔ̀	k ɑ ɹ l ə ɲ ɒ
kárlɛ̀ŋì	k ɑ ɹ l ɛ ŋ i
kárlɛ̀ŋí	k ɑ ɹ l ɛ ŋ i
kárlɛ̀ɲì	k ɑ ɹ l ɛ ɲ i
kárlɛ̀ɲí	k ɑ ɹ l ɛ ɲ i
kárò	k ɑ ɹ ow
kárt̪ìnɔ̀	k ɑ ɹ t i n ɒ
kárt̪ìnɔ́	k ɑ ɹ t i n ɒ
kárŋìt̪ɔ̀	k ɑ ɹ ŋ i t ɒ
kárŋìt̪ɔ́	k ɑ ɹ ŋ i t ɒ
kárŋɔ̀	k ɑ ɹ ŋ ɒ
kárɔ̀	k ɑ ɹ ɒ
kárɔ́	k ɑ ɹ ɒ
kárɔ́gâbá	k ɑ ɹ ɒ ɡ ɑ b ɑ
kárɔ́gɛ́	k ɑ ɹ ɒ ɡ ɛ
kátòðò	k ɑ t ow ð ow
kátòðó	k ɑ t ow ð ow
kátóðà	k ɑ t ow ð ɑ
kátùðìjí	k ɑ t ʉ ð i j i
kátúðà	k ɑ t ʉ ð ɑ
kátúðìjɔ̀	k ɑ t ʉ ð i j ɒ
kátɛ́nɔ̂nà	k ɑ t ɛ n ɒ n ɑ
kát̪át̪à	k ɑ t ɑ t ɑ
kát̪ìjé	k ɑ t i j ɛ
kát̪ìjí	k ɑ t i j i
kát̪íjà	k ɑ t i j ɑ
kát̪íjɔ̀	k ɑ t i j ɒ
kát̪òt̪ó	k ɑ t ow t ow
kát̪ɔ̀t̪ɔ́	k ɑ t ɒ t ɒ
kát̪ɔ́t̪ɔ̀	k ɑ t ɒ t ɒ
káùdɔ́	k ɑ ʉ d ɒ
káùrìjí	k ɑ ʉ ɹ i j i
káùtìðìjí	k ɑ ʉ t i ð i j i
káùtìðìðú	k ɑ ʉ t i ð i ð ʉ
káùɽcìjí	k ɑ ʉ ɹ tʃ i j i
káùɽìðìjí	k ɑ ʉ ɹ i ð i j i
káúrìjɔ̀	k ɑ ʉ ɹ i j ɒ
káútìðìjɔ̀	k ɑ ʉ t i ð i j ɒ
káútíðìðɔ̀	k ɑ ʉ t i ð i ð ɒ
káúɽcìjɔ̀	k ɑ ʉ ɹ tʃ i j ɒ
káúɽðìjɔ̀	k ɑ ʉ ɹ ð i j ɒ
kávr̀lɛ̀ðɔ́	k ɑ v ɹ l ɛ ð ɒ
kávŕlɛ̂ðà	k ɑ v ɹ l ɛ ð ɑ
kávə̀lɛ̀ðɔ́	k ɑ v ə l ɛ ð ɒ
kávə̀rðɔ́	k ɑ v ə ɹ ð ɒ
kávə́lɛ̀ðà	k ɑ v ə l ɛ ð ɑ
kávə́lɛ̀ðɛ̀	k ɑ v ə l ɛ ð ɛ
kávə́lɛ̂ðà	k ɑ v ə l ɛ ð ɑ
kávə́lɛ̂ðǎ	k ɑ v ə l ɛ ð ɑ
kávə́rlɛ̂ðà	k ɑ v ə ɹ l ɛ ð ɑ
kávə́rlɛ̂ðǎ	k ɑ v ə ɹ l ɛ ð ɑ
kávə́rðɔ̀	k ɑ v ə ɹ ð ɒ
káð	k ɑ ð
káðam̀ɔ̀cɔ	k ɑ ð ɑ m ɒ tʃ ɒ
káðàt̪ɔ́	k ɑ ð ɑ t ɒ
káðát̪à	k ɑ ð ɑ t ɑ
káðíɲɔ̀	k ɑ ð i ɲ ɒ
káðə̀və̀lɛ̀ðɔ́	k ɑ ð ə v ə l ɛ ð ɒ
káðə́və̀rlɛ̀ð̌à	k ɑ ð ə v ə ɹ l ɛ ð ɑ
káðə́və̀rlɛ̀ð̌ǎ	k ɑ ð ə v ə ɹ l ɛ ð ɑ
káðə́ŋaǎ	k ɑ ð ə ŋ ɑ ɑ
káðə́ŋîɾà	k ɑ ð ə ŋ i ɾ ɑ
káðə́ŋ̀à	k ɑ ð ə ŋ ɑ
káðɛ̀ðú	k ɑ ð ɛ ð ʉ
káðɛ́	k ɑ ð ɛ
káðɛ́və̀lèðɔ́	k ɑ ð ɛ v ə l ɛ ð ɒ
káðɛ́və́lêðɔ́	k ɑ ð ɛ v ə l ɛ ð ɒ
káðɛ́ðà	k ɑ ð ɛ ð ɑ
káŋ	k ɑ ŋ
káŋà	k ɑ ŋ ɑ
káŋácìnɛ̀	k ɑ ŋ ɑ tʃ i n ɛ
káŋárlɛ̀ɲì	k ɑ ŋ ɑ ɹ l ɛ ɲ i
káŋáŋà	k ɑ ŋ ɑ ŋ ɑ
káŋáŋá	k ɑ ŋ ɑ ŋ ɑ
káŋâ	k ɑ ŋ ɑ
káŋcî	k ɑ ŋ tʃ i
káŋcîí	k ɑ ŋ tʃ i i
káŋcɔ̀	k ɑ ŋ tʃ ɒ
káŋěn	k ɑ ŋ ɛ n
káŋì	k ɑ ŋ i
káŋìrlɛ̀ɲì	k ɑ ŋ i ɹ l ɛ ɲ i
káŋìŋì	k ɑ ŋ i ŋ i
káŋínɔ̀nà	k ɑ ŋ i n ɒ n ɑ
káŋínɔ̂nà	k ɑ ŋ i n ɒ n ɑ
káŋíŋ	k ɑ ŋ i ŋ
káŋíŋì	k ɑ ŋ i ŋ i
káŋíŋí	k ɑ ŋ i ŋ i
káŋíŋídeɛ́	k ɑ ŋ i ŋ i d ɛ ɛ
káŋíŋídɛ́	k ɑ ŋ i ŋ i d ɛ
káŋíŋî	k ɑ ŋ i ŋ i
káŋíŋ́	k ɑ ŋ i ŋ
káŋî	k ɑ ŋ i
káŋîðìɲɔ̀cɔ̀	k ɑ ŋ i ð i ɲ ɒ tʃ ɒ
káŋǐn	k ɑ ŋ i n
káŋnðə́ŋ̀ǎ	k ɑ ŋ n ð ə ŋ ɑ
káŋt̪ɛ̀	k ɑ ŋ t ɛ
káŋú	k ɑ ŋ ʉ
káŋvə́lɛ̀ðà	k ɑ ŋ v ə l ɛ ð ɑ
káŋvə́lɛ̂ðà	k ɑ ŋ v ə l ɛ ð ɑ
káŋvə́lɛ̂ðɔ́	k ɑ ŋ v ə l ɛ ð ɒ
káŋŋí	k ɑ ŋ ŋ i
káŋɛ̌n	k ɑ ŋ ɛ n
káɟà	k ɑ dʒ ɑ
káɽàŋgár	k ɑ ɹ ɑ ŋ ɡ ɑ ɹ
káɽə̀ŋàt̪ǎ	k ɑ ɹ ə ŋ ɑ t ɑ
káɽə́ŋàt̪à	k ɑ ɹ ə ŋ ɑ t ɑ
káɽə́ŋàt̪ǎ	k ɑ ɹ ə ŋ ɑ t ɑ
káɾá	k ɑ ɾ ɑ
káɾár	k ɑ ɾ ɑ ɹ
káɾát̪ɔ́	k ɑ ɾ ɑ t ɒ
káɾg	k ɑ ɾ ɡ
káɾó	k ɑ ɾ ow
káɾógɛ́	k ɑ ɾ ow ɡ ɛ
káɾór	k ɑ ɾ ow ɹ
káɾŋít̪ɛ̀	k ɑ ɾ ŋ i t ɛ
káɾɔ́	k ɑ ɾ ɒ
káɾɔ́gɛ́	k ɑ ɾ ɒ ɡ ɛ
káɾɛ̀	k ɑ ɾ ɛ
ká̌kə́lcà	k ɑ k ə l tʃ ɑ
kâdɔ̀ŋðɔ́	k ɑ d ɒ ŋ ð ɒ
kâgàɾàt̪ɔ́	k ɑ ɡ ɑ ɾ ɑ t ɒ
kâgàɾìðú	k ɑ ɡ ɑ ɾ i ð ʉ
kâgàɾó	k ɑ ɡ ɑ ɾ ow
kâi	k ɑ i
kâj	k ɑ j
kâjjí	k ɑ j j i
kâjɛ̀nìjí	k ɑ j ɛ n i j i
kâkǎŋ	k ɑ k ɑ ŋ
kâmɔ̀nt̪á	k ɑ m ɒ n t ɑ
kâmɔ̀nt̪ɔ́	k ɑ m ɒ n t ɒ
kâmɔ̀nɔ́	k ɑ m ɒ n ɒ
kândìjí	k ɑ n d i j i
kânt̪ɔ̀	k ɑ n t ɒ
kâpàt̪ɔ́	k ɑ p ɑ t ɒ
kâpìt̪ìt̪ɔ́	k ɑ p i t i t ɒ
kâpìt̪ɔ́	k ɑ p i t ɒ
kâpìðú	k ɑ p i ð ʉ
kâpìðɔ̀t̪ɔ́	k ɑ p i ð ɒ t ɒ
kâpɔ̀t̪ɔ́	k ɑ p ɒ t ɒ
kâpɔ́	k ɑ p ɒ
kâpɜ̀ìt̪ɔ́	k ɑ p ɐ i t ɒ
kârò	k ɑ ɹ ow
kârŋú	k ɑ ɹ ŋ ʉ
kârɔ́gɛ́	k ɑ ɹ ɒ ɡ ɛ
kât̪ɔ́	k ɑ t ɒ
kâvlɛ̀ðɔ́	k ɑ v l ɛ ð ɒ
kâŋtɔ́	k ɑ ŋ t ɒ
kâŋtɔ́ŋ	k ɑ ŋ t ɒ ŋ
kâŋt̪ɔ́	k ɑ ŋ t ɒ
kâŋú	k ɑ ŋ ʉ
kǎ	k ɑ
kǎgáɾàt̪ɛ̀	k ɑ ɡ ɑ ɾ ɑ t ɛ
kǎgáɾì	k ɑ ɡ ɑ ɾ i
kǎgáɾìðì	k ɑ ɡ ɑ ɾ i ð i
kǎjjì	k ɑ j j i
kǎjɛ̀	k ɑ j ɛ
kǎjɛ̌	k ɑ j ɛ
kǎl	k ɑ l
kǎllɛ́rɛ́r	k ɑ l l ɛ ɹ ɛ ɹ
kǎlvə́lɛ̀ðàló	k ɑ l v ə l ɛ ð ɑ l ow
kǎl̀və̀lɛ̀ðɛ̀	k ɑ l v ə l ɛ ð ɛ
kǎmíɲàt̪ɛ̀	k ɑ m i ɲ ɑ t ɛ
kǎndíjì	k ɑ n d i j i
kǎpà	k ɑ p ɑ
kǎpát̪à	k ɑ p ɑ t ɑ
kǎpát̪ɛ̀	k ɑ p ɑ t ɛ
kǎpít̪ɔ̀	k ɑ p i t ɒ
kǎpíðà	k ɑ p i ð ɑ
kǎpíðɔ̀	k ɑ p i ð ɒ
kǎpíðɔ̀t̪ɔ̀	k ɑ p i ð ɒ t ɒ
kǎpɔ̀	k ɑ p ɒ
kǎpɔ́t̪ɔ̀	k ɑ p ɒ t ɒ
kǎpɜ́ìt̪ɔ̀	k ɑ p ɐ i t ɒ
kǎr	k ɑ ɹ
kǎvə́lɛ̂ðǎ	k ɑ v ə l ɛ ð ɑ
kǎŋà	k ɑ ŋ ɑ
kǎŋt̪à	k ɑ ŋ t ɑ
kdɔ̀ɽðɔ̀t̪ɔ̀	k d ɒ ɹ ð ɒ t ɒ
kdɔ̀ɽðɔ̀t̪ɔ́	k d ɒ ɹ ð ɒ t ɒ
kècèló	k ɛ tʃ ɛ l ow
kèclò	k ɛ tʃ l ow
kègàró	k ɛ ɡ ɑ ɹ ow
kèné	k ɛ n ɛ
kèró	k ɛ ɹ ow
kèɲá	k ɛ ɲ ɑ
ké	k ɛ
kéd̪ɔ̀ɽɔ̀l	k ɛ d ɒ ɹ ɒ l
kéðúɽí	k ɛ ð ʉ ɹ i
kéɲɔ́	k ɛ ɲ ɒ
kê	k ɛ
kě	k ɛ
kicəlo	k i tʃ ə l ow
kicə̀lò	k i tʃ ə l ow
kirlɛɲi	k i ɹ l ɛ ɲ i
kiɲɔ́	k i ɲ ɒ
kìbránánù	k i b ɹ ɑ n ɑ n ʉ
kìbɽánànò	k i b ɹ ɑ n ɑ n ow
kìbɽánànù	k i b ɹ ɑ n ɑ n ʉ
kìcìlò	k i tʃ i l ow
kìcìló	k i tʃ i l ow
kìclò	k i tʃ l ow
kìclǒ	k i tʃ l ow
kìcò	k i tʃ ow
kìcɔ̀	k i tʃ ɒ
kìcəlò	k i tʃ ə l ow
kìcə̀lò	k i tʃ ə l ow
kìcə̀ló	k i tʃ ə l ow
kìcə̀lù	k i tʃ ə l ʉ
kìcə̀lʊ̀	k i tʃ ə l ʊ
kìcɛ̀lù	k i tʃ ɛ l ʉ
kìjàt̪à	k i j ɑ t ɑ
kìjàt̪áŋá	k i j ɑ t ɑ ŋ ɑ
kìjàt̪ɔ́	k i j ɑ t ɒ
kìjá	k i j ɑ
kìjìnìjí	k i j i n i j i
kìjjí	k i j j i
kìjó	k i j ow
kìjɔ́	k i j ɒ
kìpí	k i p i
kìtcə̀lò	k i t tʃ ə l ow
kìðìɲɔ́	k i ð i ɲ ɒ
kìðɔ́	k i ð ɒ
kìɲàrvə́lɛ̂ðɛ̀	k i ɲ ɑ ɹ v ə l ɛ ð ɛ
kìɲálɛ̂rɛ̀	k i ɲ ɑ l ɛ ɹ ɛ
kìɲálɛ̂rɛ́	k i ɲ ɑ l ɛ ɹ ɛ
kìɲárnɔ̂nà	k i ɲ ɑ ɹ n ɒ n ɑ
kìɲárvə́lɛ̂ðɛ̀	k i ɲ ɑ ɹ v ə l ɛ ð ɛ
kìɲɔ̀	k i ɲ ɒ
kìɲɔ́	k i ɲ ɒ
kìɽánó	k i ɹ ɑ n ow
kìɽɔ́	k i ɹ ɒ
kícìlǒ	k i tʃ i l ow
kícɔ́	k i tʃ ɒ
kícə̀láno	k i tʃ ə l ɑ n ow
kícə̀lánú	k i tʃ ə l ɑ n ʉ
kícə̀lò	k i tʃ ə l ow
kícə̀ló	k i tʃ ə l ow
kícə̀lù	k i tʃ ə l ʉ
kícə́ló	k i tʃ ə l ow
kíjà	k i j ɑ
kíjàt̪à	k i j ɑ t ɑ
kíjá	k i j ɑ
kíjêðè	k i j ɛ ð ɛ
kíjó	k i j ow
kíjɔ̀l	k i j ɒ l
kíjɔ́	k i j ɒ
kíjɔ́ŋ	k i j ɒ ŋ
kílì	k i l i
kílìŋɔ́	k i l i ŋ ɒ
kílə̀ŋɔ́	k i l ə ŋ ɒ
kínà	k i n ɑ
kínǎ	k i n ɑ
kíndɔ̀	k i n d ɒ
kírlɛ̀ŋí	k i ɹ l ɛ ŋ i
kírlɛ̀ɲí	k i ɹ l ɛ ɲ i
kítàɽàn	k i t ɑ ɹ ɑ n
kívə̀lɛ̀ðɔ́	k i v ə l ɛ ð ɒ
kíðìnt̪ɔ́	k i ð i n t ɒ
kíðìnɔ̀	k i ð i n ɒ
kíðìnɔ́	k i ð i n ɒ
kíðìɲɔ́	k i ð i ɲ ɒ
kíðɔ̀	k i ð ɒ
kíðɔ́	k i ð ɒ
kíðɛ̀	k i ð ɛ
kíŋâgɛ̀rɛ́	k i ŋ ɑ ɡ ɛ ɹ ɛ
kíɲàt̪à	k i ɲ ɑ t ɑ
kíɲâlɛ̀rɛ̀	k i ɲ ɑ l ɛ ɹ ɛ
kíɲâlɛ̀ɾɛ́	k i ɲ ɑ l ɛ ɾ ɛ
kíɽɔ́l	k i ɹ ɒ l
kîðɔ̀	k i ð ɒ
kîðɔ̌	k i ð ɒ
kĺcí	k l tʃ i
kmnà	k m n ɑ
km̀nǎ	k m n ɑ
kńnà	k n n ɑ
kńnǎ	k n n ɑ
kòalà	k ow ɑ l ɑ
kòlà	k ow l ɑ
kòɲá	k ow ɲ ɑ
kónè	k ow n ɛ
kórìŋú	k ow ɹ i ŋ ʉ
kr	k ɹ
kràráò	k ɹ ɑ ɹ ɑ ow
kràráó	k ɹ ɑ ɹ ɑ ow
kràráǒ	k ɹ ɑ ɹ ɑ ow
ku	k ʉ
kuku	k ʉ k ʉ
kukuŋa	k ʉ k ʉ ŋ ɑ
kukuŋu	k ʉ k ʉ ŋ ʉ
kukú	k ʉ k ʉ
kukǔ	k ʉ k ʉ
kuŋú	k ʉ ŋ ʉ
kùdɔ́	k ʉ d ɒ
kùmbùt̪ɔ̀	k ʉ m b ʉ t ɒ
kùmùt̪èná	k ʉ m ʉ t ɛ n ɑ
kùmùt̪ènɔ́	k ʉ m ʉ t ɛ n ɒ
kùmùt̪nɔ́ŋ	k ʉ m ʉ t n ɒ ŋ
kùmùt̪ùnɔ́	k ʉ m ʉ t ʉ n ɒ
kùmùt̪ɔ̀	k ʉ m ʉ t ɒ
kùmùt̪ɛ̀	k ʉ m ʉ t ɛ
kùmùt̪ɛ̀níŋì	k ʉ m ʉ t ɛ n i ŋ i
kùnɛ̀rè	k ʉ n ɛ ɹ ɛ
kùpɔ́	k ʉ p ɒ
kùrìjí	k ʉ ɹ i j i
kùrmùðɔ́	k ʉ ɹ m ʉ ð ɒ
kùrŋú	k ʉ ɹ ŋ ʉ
kùtìðìjí	k ʉ t i ð i j i
kùtìðìðú	k ʉ t i ð i ð ʉ
kùtìðí	k ʉ t i ð i
kùtòðìjí	k ʉ t ow ð i j i
kùtòðò	k ʉ t ow ð ow
kùtùðìjí	k ʉ t ʉ ð i j i
kùuijì	k ʉ ʉ i j i
kùwɔ̀	k ʉ w ɒ
kùŋút̪ì	k ʉ ŋ ʉ t i
kùɟí	k ʉ dʒ i
kùɽcìjí	k ʉ ɹ tʃ i j i
kùɽðìjí	k ʉ ɹ ð i j i
kùɾmùðɔ́	k ʉ ɾ m ʉ ð ɒ
kújɛ̀l	k ʉ j ɛ l
kúkàrt̪̀ná	k ʉ k ɑ ɹ t n ɑ
kúku	k ʉ k ʉ
kúkuŋú	k ʉ k ʉ ŋ ʉ
kúkù	k ʉ k ʉ
kúkùart̪ìnà	k ʉ k ʉ ɑ ɹ t i n ɑ
kúkùŋ	k ʉ k ʉ ŋ
kúkùŋà	k ʉ k ʉ ŋ ɑ
kúkùŋí	k ʉ k ʉ ŋ i
kúkùŋídí	k ʉ k ʉ ŋ i d i
kúkùŋu	k ʉ k ʉ ŋ ʉ
kúkùŋù	k ʉ k ʉ ŋ ʉ
kúkùŋùnɛ̀ɾɛ̀	k ʉ k ʉ ŋ ʉ n ɛ ɾ ɛ
kúkùŋú	k ʉ k ʉ ŋ ʉ
kúkùŋúdì	k ʉ k ʉ ŋ ʉ d i
kúkùŋúnɛ̀ɾɛ̀	k ʉ k ʉ ŋ ʉ n ɛ ɾ ɛ
kúkùŋúðɛ́dì	k ʉ k ʉ ŋ ʉ ð ɛ d i
kúkùŋðɔ́ndà	k ʉ k ʉ ŋ ð ɒ n d ɑ
kúkùŋɔ̀ŋŋíɲár	k ʉ k ʉ ŋ ɒ ŋ ŋ i ɲ ɑ ɹ
kúkùŋ́	k ʉ k ʉ ŋ
kúkú	k ʉ k ʉ
kúkúkɔ̀ɾt̪ɔ́l	k ʉ k ʉ k ɒ ɾ t ɒ l
kúkúŋ	k ʉ k ʉ ŋ
kúkúŋu	k ʉ k ʉ ŋ ʉ
kúkúŋù	k ʉ k ʉ ŋ ʉ
kúkúŋú	k ʉ k ʉ ŋ ʉ
kúkû	k ʉ k ʉ
kúkǔ	k ʉ k ʉ
kúkʊ̀	k ʉ k ʊ
kúkʊ̀ŋʊ́	k ʉ k ʊ ŋ ʊ
kúmùt̪ɛ̀	k ʉ m ʉ t ɛ
kúnɔ̂ná	k ʉ n ɒ n ɑ
kúrǐ	k ʉ ɹ i
kúù	k ʉ ʉ
kúŋál	k ʉ ŋ ɑ l
kúɟí	k ʉ dʒ i
kúɽi	k ʉ ɹ i
kúɽì	k ʉ ɹ i
kúɽìɟèn	k ʉ ɹ i dʒ ɛ n
kúɽìɟɛ̀n	k ʉ ɹ i dʒ ɛ n
kúɽí	k ʉ ɹ i
kúɽî	k ʉ ɹ i
kúɽùɔ̀	k ʉ ɹ ʉ ɒ
kúɽùɛ̀l	k ʉ ɹ ʉ ɛ l
kúɽùɛ́l	k ʉ ɹ ʉ ɛ l
kwìcə̀lò	k w i tʃ ə l ow
kŋ	k ŋ
kŋàcìnɔ́	k ŋ ɑ tʃ i n ɒ
kŋɔ̀cí	k ŋ ɒ tʃ i
kɔɲ	k ɒ ɲ
kɔ̀cɔ́	k ɒ tʃ ɒ
kɔ̀kɔ̀	k ɒ k ɒ
kɔ̀là	k ɒ l ɑ
kɔ̀lá	k ɒ l ɑ
kɔ̀lit̪ɔ́	k ɒ l i t ɒ
kɔ̀lìt̪ɔ́	k ɒ l i t ɒ
kɔ̀mùt̪ɔ̀	k ɒ m ʉ t ɒ
kɔ̀mùt̪ɛ̀ní	k ɒ m ʉ t ɛ n i
kɔ̀n	k ɒ n
kɔ̀rì	k ɒ ɹ i
kɔ̀rmùðɔ̀	k ɒ ɹ m ʉ ð ɒ
kɔ̀rnɔ́	k ɒ ɹ n ɒ
kɔ̀tìðɛ̀cí	k ɒ t i ð ɛ tʃ i
kɔ̀tɛ̀cí	k ɒ t ɛ tʃ i
kɔ̀t̪à	k ɒ t ɑ
kɔ̀t̪á	k ɒ t ɑ
kɔ̀t̪ìnɔ́	k ɒ t i n ɒ
kɔ̀ŋɔ̂	k ɒ ŋ ɒ
kɔ̀ɽɟɛ̀cáŋà	k ɒ ɹ dʒ ɛ tʃ ɑ ŋ ɑ
kɔ̀ɽɟɛ̀cáŋá	k ɒ ɹ dʒ ɛ tʃ ɑ ŋ ɑ
kɔ̀ɽɟɛ̀cáŋánunɛɾɛ	k ɒ ɹ dʒ ɛ tʃ ɑ ŋ ɑ n ʉ n ɛ ɾ ɛ
kɔ̀ɽɟɛ̀cíŋ	k ɒ ɹ dʒ ɛ tʃ i ŋ
kɔ̀ɽɟɛ̀cíŋì	k ɒ ɹ dʒ ɛ tʃ i ŋ i
kɔ̀ɽɟɛ̀cíŋí	k ɒ ɹ dʒ ɛ tʃ i ŋ i
kɔ̀ɾùŋú	k ɒ ɾ ʉ ŋ ʉ
kɔ́bə̀cɔ̀	k ɒ b ə tʃ ɒ
kɔ́cí	k ɒ tʃ i
kɔ́lɔ̀tɔ̀	k ɒ l ɒ t ɒ
kɔ́lɔ̀t̪ɔ̀	k ɒ l ɒ t ɒ
kɔ́lɔ̀t̪ɔ̌	k ɒ l ɒ t ɒ
kɔ́n	k ɒ n
kɔ́rà	k ɒ ɹ ɑ
kɔ́rì	k ɒ ɹ i
kɔ́rìŋú	k ɒ ɹ i ŋ ʉ
kɔ́t̪à	k ɒ t ɑ
kɔ́t̪ìnò	k ɒ t i n ow
kɔ́t̪ìt̪ìðɔ̀	k ɒ t i t i ð ɒ
kɔ́t̪ìðà	k ɒ t i ð ɑ
kɔ́t̪ínɔ́	k ɒ t i n ɒ
kɔ́t̪ɔ̀t̪à	k ɒ t ɒ t ɑ
kɔ́t̪ɔ̀t̪ɔ́	k ɒ t ɒ t ɒ
kɔ́t̪ɔ́	k ɒ t ɒ
kɔ́ðàŋɔ́nà	k ɒ ð ɑ ŋ ɒ n ɑ
kɔ́ɲà	k ɒ ɲ ɑ
kɔ́ɽàt̪ɔ̀	k ɒ ɹ ɑ t ɒ
kɔ́ɽɔ̀tɔ̀	k ɒ ɹ ɒ t ɒ
kɔ́ɽɟɛ̀cì	k ɒ ɹ dʒ ɛ tʃ i
kɔ́ɽɟɛ̀cí	k ɒ ɹ dʒ ɛ tʃ i
kɔ́ɾà	k ɒ ɾ ɑ
kɔ́ɾì	k ɒ ɾ i
kɔ̂d	k ɒ d
kɔ̂dɔ́	k ɒ d ɒ
kɔ̂ɔ́n	k ɒ ɒ n
kəcó	k ə tʃ ow
kərá	k ə ɹ ɑ
kərmnǎ	k ə ɹ m n ɑ
kər̀mnà	k ə ɹ m n ɑ
kə̀bùlìjátɛ́	k ə b ʉ l i j ɑ t ɛ
kə̀bùlìjátɛ́r	k ə b ʉ l i j ɑ t ɛ ɹ
kə̀bùlìjáŋà	k ə b ʉ l i j ɑ ŋ ɑ
kə̀bùlìjáŋá	k ə b ʉ l i j ɑ ŋ ɑ
kə̀bùlìjáɲà	k ə b ʉ l i j ɑ ɲ ɑ
kə̀bùlìjáɲá	k ə b ʉ l i j ɑ ɲ ɑ
kə̀bùlìjí	k ə b ʉ l i j i
kə̀bùlìjíŋ	k ə b ʉ l i j i ŋ
kə̀bùlìjíŋì	k ə b ʉ l i j i ŋ i
kə̀bùlìjíŋí	k ə b ʉ l i j i ŋ i
kə̀bùlìjíɲárɛ́	k ə b ʉ l i j i ɲ ɑ ɹ ɛ
kə̀bùlìjîl	k ə b ʉ l i j i l
kə̀bùlìjɛ̀cí	k ə b ʉ l i j ɛ tʃ i
kə̀bùlìjɛ́ŋì	k ə b ʉ l i j ɛ ŋ i
kə̀bùlìjɜ́lí	k ə b ʉ l i j ɐ l i
kə̀bùlìjɜ́lír	k ə b ʉ l i j ɐ l i ɹ
kə̀bùt̪ɔ̀	k ə b ʉ t ɒ
kə̀bɽànánò	k ə b ɹ ɑ n ɑ n ow
kə̀bɽá	k ə b ɹ ɑ
kə̀bɽánànò	k ə b ɹ ɑ n ɑ n ow
kə̀bɽánànǒ	k ə b ɹ ɑ n ɑ n ow
kə̀bɽɔ́gɛ́	k ə b ɹ ɒ ɡ ɛ
kə̀cə̀lò	k ə tʃ ə l ow
kə̀dɔ̀ŋnɔ́	k ə d ɒ ŋ n ɒ
kə̀dɔ̀ŋðɔ́	k ə d ɒ ŋ ð ɒ
kə̀dɔ̀ɽðɔ̀t̪ɔ́	k ə d ɒ ɹ ð ɒ t ɒ
kə̀gɛ̀cìðù	k ə ɡ ɛ tʃ i ð ʉ
kə̀gɛ̀cìðú	k ə ɡ ɛ tʃ i ð ʉ
kə̀kə̀cɛ̀cí	k ə k ə tʃ ɛ tʃ i
kə̀kɛ̀cí	k ə k ɛ tʃ i
kə̀lcàcá	k ə l tʃ ɑ tʃ ɑ
kə̀lcá	k ə l tʃ ɑ
kə̀lə̀ŋɔ́	k ə l ə ŋ ɒ
kə̀lɛ̀və̀cìtíŋì	k ə l ɛ v ə tʃ i t i ŋ i
kə̀lɛ̀və̀cìt̪íŋí	k ə l ɛ v ə tʃ i t i ŋ i
kə̀lɛ̀ŋìcáà	k ə l ɛ ŋ i tʃ ɑ ɑ
kə̀lɛ̀ŋìcáŋà	k ə l ɛ ŋ i tʃ ɑ ŋ ɑ
kə̀màðìt̪ɔ́	k ə m ɑ ð i t ɒ
kə̀mìɲàt̪ɔ́	k ə m i ɲ ɑ t ɒ
kə̀mnà	k ə m n ɑ
kə̀mnǎ	k ə m n ɑ
kə̀mùt̪ù	k ə m ʉ t ʉ
kə̀mùt̪ùná	k ə m ʉ t ʉ n ɑ
kə̀mùt̪ɔ̀	k ə m ʉ t ɒ
kə̀mùt̪ɛ̀	k ə m ʉ t ɛ
kə̀mùt̪ɛ̀ní	k ə m ʉ t ɛ n i
kə̀mɛ̀ðìt̪ɔ́	k ə m ɛ ð i t ɒ
kə̀nnà	k ə n n ɑ
kə̀nɔ̀nɔ́	k ə n ɒ n ɒ
kə̀pìt̪ìt̪ɔ́	k ə p i t i t ɒ
kə̀pìt̪ɔ́	k ə p i t ɒ
kə̀pìðú	k ə p i ð ʉ
kə̀pìðɔ̀t̪ɔ́	k ə p i ð ɒ t ɒ
kə̀pɔ̀t̪ɔ́	k ə p ɒ t ɒ
kə̀pɔ́	k ə p ɒ
kə̀pɜ̀ìt̪ɔ́	k ə p ɐ i t ɒ
kə̀rdɔ́	k ə ɹ d ɒ
kə̀rkɛ̌v	k ə ɹ k ɛ v
kə̀rlànd̪àt̪ɔ́	k ə ɹ l ɑ n d ɑ t ɒ
kə̀rlànd̪ɔ́	k ə ɹ l ɑ n d ɒ
kə̀rlɛ̀nd̪ìt̪ɔ́	k ə ɹ l ɛ n d i t ɒ
kə̀rlɛ̀ɲí	k ə ɹ l ɛ ɲ i
kə̀rŋìt̪ɔ́	k ə ɹ ŋ i t ɒ
kə̀rə̀mná	k ə ɹ ə m n ɑ
kə̀t̪ìjé	k ə t i j ɛ
kə̀t̪ìjí	k ə t i j i
kə̀t̪ìðú	k ə t i ð ʉ
kə̀t̪ó	k ə t ow
kə̀t̪ɔ̀t̪ɔ́	k ə t ɒ t ɒ
kə̀t̪ɔ̀ðɔ̀t̪ɔ́	k ə t ɒ ð ɒ t ɒ
kə̀t̪ɔ́	k ə t ɒ
kə̀t̪ɛ̀ví	k ə t ɛ v i
kə̀vé	k ə v ɛ
kə̀vlɛ̀ðɔ́	k ə v l ɛ ð ɒ
kə̀vlɛ̀ðɛ́ɲárɛ́	k ə v l ɛ ð ɛ ɲ ɑ ɹ ɛ
kə̀və̀lɛ̀ðálí	k ə v ə l ɛ ð ɑ l i
kə̀və̀lɛ̀ðálír	k ə v ə l ɛ ð ɑ l i ɹ
kə̀və̀lɛ̀ðátɛ̀	k ə v ə l ɛ ð ɑ t ɛ
kə̀və̀lɛ̀ðátɛ́	k ə v ə l ɛ ð ɑ t ɛ
kə̀və̀lɛ̀ðátɛ́r	k ə v ə l ɛ ð ɑ t ɛ ɹ
kə̀və̀lɛ̀ðáŋà	k ə v ə l ɛ ð ɑ ŋ ɑ
kə̀və̀lɛ̀ðáŋá	k ə v ə l ɛ ð ɑ ŋ ɑ
kə̀və̀lɛ̀ðáŋǎ	k ə v ə l ɛ ð ɑ ŋ ɑ
kə̀və̀lɛ̀ðáɲà	k ə v ə l ɛ ð ɑ ɲ ɑ
kə̀və̀lɛ̀ðáɲá	k ə v ə l ɛ ð ɑ ɲ ɑ
kə̀və̀lɛ̀ðìnɔ́	k ə v ə l ɛ ð i n ɒ
kə̀və̀lɛ̀ðɔ̀	k ə v ə l ɛ ð ɒ
kə̀və̀lɛ̀ðɔ̀ŋ	k ə v ə l ɛ ð ɒ ŋ
kə̀və̀lɛ̀ðɔ́	k ə v ə l ɛ ð ɒ
kə̀və̀lɛ̀ðɔ́lŋù	k ə v ə l ɛ ð ɒ l ŋ ʉ
kə̀və̀lɛ̀ðɔ́ŋ	k ə v ə l ɛ ð ɒ ŋ
kə̀və̀lɛ̀ðɔ̂l	k ə v ə l ɛ ð ɒ l
kə̀və̀lɛ̀ðɛ́ŋì	k ə v ə l ɛ ð ɛ ŋ i
kə̀və̀lɛ̀ðɛ́ŋí	k ə v ə l ɛ ð ɛ ŋ i
kə̀və̀lɛ̀ðɛ́ɲárɛ̀	k ə v ə l ɛ ð ɛ ɲ ɑ ɹ ɛ
kə̀və̀lɛ̀ðɛ́ɲárɛ́	k ə v ə l ɛ ð ɛ ɲ ɑ ɹ ɛ
kə̀və̀lɛ̀ðɛ́ɲáɾɛ́	k ə v ə l ɛ ð ɛ ɲ ɑ ɾ ɛ
kə̀və̀lɛ̀ðɜ́lə́ŋó	k ə v ə l ɛ ð ɐ l ə ŋ ow
kə̀və̀rðɔ́	k ə v ə ɹ ð ɒ
kə̀ðàt̪ɔ́	k ə ð ɑ t ɒ
kə̀ðìɲɔ́	k ə ð i ɲ ɒ
kə̀ðó	k ə ð ow
kə̀ŋací	k ə ŋ ɑ tʃ i
kə̀ŋàcáŋá	k ə ŋ ɑ tʃ ɑ ŋ ɑ
kə̀ŋàcâ	k ə ŋ ɑ tʃ ɑ
kə̀ŋàcâŋà	k ə ŋ ɑ tʃ ɑ ŋ ɑ
kə̀ŋàcâŋǎ	k ə ŋ ɑ tʃ ɑ ŋ ɑ
kə̀ŋàcí	k ə ŋ ɑ tʃ i
kə̀ŋàcî	k ə ŋ ɑ tʃ i
kə̀ŋàcîí	k ə ŋ ɑ tʃ i i
kə̀ŋàcîŋì	k ə ŋ ɑ tʃ i ŋ i
kə̀ŋàcîŋí	k ə ŋ ɑ tʃ i ŋ i
kə̀ŋàcîŋǐ	k ə ŋ ɑ tʃ i ŋ i
kə̀ɔ̀ɽɟɛ̀cáŋà	k ə ɒ ɹ dʒ ɛ tʃ ɑ ŋ ɑ
kə̀ɔ̀ɽɟɛ̀cáŋá	k ə ɒ ɹ dʒ ɛ tʃ ɑ ŋ ɑ
kə̀ɔ̀ɽɟɛ̀cíŋ	k ə ɒ ɹ dʒ ɛ tʃ i ŋ
kə̀ɔ̀ɽɟɛ̀cíŋì	k ə ɒ ɹ dʒ ɛ tʃ i ŋ i
kə̀ɔ̀ɽɟɛ̀cíŋí	k ə ɒ ɹ dʒ ɛ tʃ i ŋ i
kə̀ɽà	k ə ɹ ɑ
kə̀ɽàɲìðú	k ə ɹ ɑ ɲ i ð ʉ
kə̀ɽá	k ə ɹ ɑ
kə̀ɽìŋàt̪ɔ́	k ə ɹ i ŋ ɑ t ɒ
kə̀ɽìɲáɲàggɛ̀	k ə ɹ i ɲ ɑ ɲ ɑ ɡ ɡ ɛ
kə̀ɾùŋɔ̀t̪ɔ́	k ə ɾ ʉ ŋ ɒ t ɒ
kə́	k ə
kə́dɔ̀ŋnɔ́	k ə d ɒ ŋ n ɒ
kə́dɔ̀ŋðɔ́	k ə d ɒ ŋ ð ɒ
kə́dɔ́ŋðɛ̀	k ə d ɒ ŋ ð ɛ
kə́lcà	k ə l tʃ ɑ
kə́lcácí	k ə l tʃ ɑ tʃ i
kə́lcǎ	k ə l tʃ ɑ
kə́lcí	k ə l tʃ i
kə́lə̀ŋɔ́	k ə l ə ŋ ɒ
kə́nà	k ə n ɑ
kə́nɔ̀nt̪ɔ́t̪ɔ́l	k ə n ɒ n t ɒ t ɒ l
kə́nɔ́nà	k ə n ɒ n ɑ
kə́nɔ́ná	k ə n ɒ n ɑ
kə́nɔ́nǎ	k ə n ɒ n ɑ
kə́r	k ə ɹ
kə́râmná	k ə ɹ ɑ m n ɑ
kə́rlɛ̀ɲí	k ə ɹ l ɛ ɲ i
kə́rlɛ̀ɲígɛ́	k ə ɹ l ɛ ɲ i ɡ ɛ
kə́rɔ́ðɔ́	k ə ɹ ɒ ð ɒ
kə́rəmná	k ə ɹ ə m n ɑ
kə́rə̀mná	k ə ɹ ə m n ɑ
kə́rə́mná	k ə ɹ ə m n ɑ
kə́vlàt̪à	k ə v l ɑ t ɑ
kə́və̀lɛ̀ðɔ̀	k ə v ə l ɛ ð ɒ
kə́və̀lɛ̀ðɔ̀l	k ə v ə l ɛ ð ɒ l
kə́və̀lɛ̀ðɔ́	k ə v ə l ɛ ð ɒ
kə́və̀lɛ̀ðɔ́gɛ́	k ə v ə l ɛ ð ɒ ɡ ɛ
kə́və́lɛ̀ðɔ̀	k ə v ə l ɛ ð ɒ
kə́ðàlgàráj	k ə ð ɑ l ɡ ɑ ɹ ɑ j
kə́ðìɲìjí	k ə ð i ɲ i j i
kə́ðìɲɔ́	k ə ð i ɲ ɒ
kə́ðíɲɔ́	k ə ð i ɲ ɒ
kə́ðə̀ŋnɔ́	k ə ð ə ŋ n ɒ
kə́ðə̀ŋnɔ́l	k ə ð ə ŋ n ɒ l
kə́ŋàcí	k ə ŋ ɑ tʃ i
kə́ŋɜ̀cìnɔ́	k ə ŋ ɐ tʃ i n ɒ
kə́ɽà	k ə ɹ ɑ
kə́ɽìŋàt̪ɔ́l	k ə ɹ i ŋ ɑ t ɒ l
kə́ɾɔ́ðɔ́	k ə ɾ ɒ ð ɒ
kə̌nà	k ə n ɑ
kɛáń	k ɛ ɑ n
kɛðəŋnɔl	k ɛ ð ə ŋ n ɒ l
kɛ̀	k ɛ
kɛ̀cìŋgàlàlátɛ́r	k ɛ tʃ i ŋ ɡ ɑ l ɑ l ɑ t ɛ ɹ
kɛ̀dí	k ɛ d i
kɛ̀ìdù	k ɛ i d ʉ
kɛ̀ìdú	k ɛ i d ʉ
kɛ̀ìdɔ̀t̪ɔ́	k ɛ i d ɒ t ɒ
kɛ̀kə̀cɛ̀cí	k ɛ k ə tʃ ɛ tʃ i
kɛ̀kə̀lcí	k ɛ k ə l tʃ i
kɛ̀lcí	k ɛ l tʃ i
kɛ̀lɛ̀və̀càcíŋí	k ɛ l ɛ v ə tʃ ɑ tʃ i ŋ i
kɛ̀lɛ̀ŋìt̪ɔ́	k ɛ l ɛ ŋ i t ɒ
kɛ̀lɛ̀ŋɛ̀t̪ɔ́	k ɛ l ɛ ŋ ɛ t ɒ
kɛ̀màðìt̪ɔ́	k ɛ m ɑ ð i t ɒ
kɛ̀mìɲàt̪ɔ́	k ɛ m i ɲ ɑ t ɒ
kɛ̀mìɲɔ̀	k ɛ m i ɲ ɒ
kɛ̀mìɲɔ́	k ɛ m i ɲ ɒ
kɛ̀mùt̪	k ɛ m ʉ t
kɛ̀mùt̪èní	k ɛ m ʉ t ɛ n i
kɛ̀mùt̪ù	k ɛ m ʉ t ʉ
kɛ̀mùt̪ɔ̀	k ɛ m ʉ t ɒ
kɛ̀mùt̪ɔ̀ná	k ɛ m ʉ t ɒ n ɑ
kɛ̀mùt̪ɛ̀	k ɛ m ʉ t ɛ
kɛ̀mùt̪ɛ̀nɔ́	k ɛ m ʉ t ɛ n ɒ
kɛ̀mùt̪̀ní	k ɛ m ʉ t n i
kɛ̀mùt̪̀nɔ́ŋ	k ɛ m ʉ t n ɒ ŋ
kɛ̀mút̪ɔ̀	k ɛ m ʉ t ɒ
kɛ̀ndìjí	k ɛ n d i j i
kɛ̀nnɛ̀	k ɛ n n ɛ
kɛ̀nɛ́	k ɛ n ɛ
kɛ̀pìðú	k ɛ p i ð ʉ
kɛ̀rlɛ̀nd̪ìjí	k ɛ ɹ l ɛ n d i j i
kɛ̀t̪ìjé	k ɛ t i j ɛ
kɛ̀t̪ìjí	k ɛ t i j i
kɛ̀t̪ó	k ɛ t ow
kɛ̀t̪ɔ̀t̪ɔ́	k ɛ t ɒ t ɒ
kɛ̀t̪ɔ́	k ɛ t ɒ
kɛ̀t̪ə̀t̪ɔ́	k ɛ t ə t ɒ
kɛ̀t̪ɛ̀t̪ó	k ɛ t ɛ t ow
kɛ̀ðɛ̀ðú	k ɛ ð ɛ ð ʉ
kɛ̀ɲɛ̀làcálí	k ɛ ɲ ɛ l ɑ tʃ ɑ l i
kɛ̀ɲɛ̀làcálír	k ɛ ɲ ɛ l ɑ tʃ ɑ l i ɹ
kɛ̀ɲɛ̀làcátɛ́	k ɛ ɲ ɛ l ɑ tʃ ɑ t ɛ
kɛ̀ɲɛ̀làcátɛ́r	k ɛ ɲ ɛ l ɑ tʃ ɑ t ɛ ɹ
kɛ̀ɲɛ̀làcáŋà	k ɛ ɲ ɛ l ɑ tʃ ɑ ŋ ɑ
kɛ̀ɲɛ̀làcáŋá	k ɛ ɲ ɛ l ɑ tʃ ɑ ŋ ɑ
kɛ̀ɲɛ̀làcíl̀	k ɛ ɲ ɛ l ɑ tʃ i l
kɛ̀ɲɛ̀làcíŋ	k ɛ ɲ ɛ l ɑ tʃ i ŋ
kɛ̀ɲɛ̀làcíŋì	k ɛ ɲ ɛ l ɑ tʃ i ŋ i
kɛ̀ɲɛ̀làcíŋí	k ɛ ɲ ɛ l ɑ tʃ i ŋ i
kɛ̀ɲɛ̀làcíɲárɛ́	k ɛ ɲ ɛ l ɑ tʃ i ɲ ɑ ɹ ɛ
kɛ̀ɲɛ̀làcɛ́ɲà	k ɛ ɲ ɛ l ɑ tʃ ɛ ɲ ɑ
kɛ̀ɲɛ̀làcɛ́ɲá	k ɛ ɲ ɛ l ɑ tʃ ɛ ɲ ɑ
kɛ̀ɽánò	k ɛ ɹ ɑ n ow
kɛ̀ɽánó	k ɛ ɹ ɑ n ow
kɛ̀ɽìɲáɲàgɛ̌	k ɛ ɹ i ɲ ɑ ɲ ɑ ɡ ɛ
kɛ̀ɽðìðɔ́	k ɛ ɹ ð i ð ɒ
kɛ̀ɽðɔ́	k ɛ ɹ ð ɒ
kɛ̀ɾá	k ɛ ɾ ɑ
kɛ̀̀	k ɛ
kɛ́	k ɛ
kɛ́cɛ́cí	k ɛ tʃ ɛ tʃ i
kɛ́lcà	k ɛ l tʃ ɑ
kɛ́líjàl	k ɛ l i j ɑ l
kɛ́lɛ̀ŋìt̪á	k ɛ l ɛ ŋ i t ɑ
kɛ́lɛ̀ŋìt̪ɔ́	k ɛ l ɛ ŋ i t ɒ
kɛ́mùt̪ù	k ɛ m ʉ t ʉ
kɛ́mùt̪ɔ́	k ɛ m ʉ t ɒ
kɛ́mút̪ɔ́̀	k ɛ m ʉ t ɒ
kɛ́ně	k ɛ n ɛ
kɛ́nɔ̀n	k ɛ n ɒ n
kɛ́nɔ̀nt̪ɔ́t̪ɔ́	k ɛ n ɒ n t ɒ t ɒ
kɛ́nɔ̀nt̪ɔ́t̪ɔ́l	k ɛ n ɒ n t ɒ t ɒ l
kɛ́nɔ́nà	k ɛ n ɒ n ɑ
kɛ́nɔ̂nà	k ɛ n ɒ n ɑ
kɛ́r	k ɛ ɹ
kɛ́rdɛ̀cí	k ɛ ɹ d ɛ tʃ i
kɛ́rlə̀ɲí	k ɛ ɹ l ə ɲ i
kɛ́rlɛ̀ɲáŋà	k ɛ ɹ l ɛ ɲ ɑ ŋ ɑ
kɛ́rlɛ̀ɲáŋá	k ɛ ɹ l ɛ ɲ ɑ ŋ ɑ
kɛ́rlɛ̀ɲì	k ɛ ɹ l ɛ ɲ i
kɛ́rlɛ̀ɲíŋí	k ɛ ɹ l ɛ ɲ i ŋ i
kɛ́ðìnt̪ɔ́	k ɛ ð i n t ɒ
kɛ́ðìnɔ̀	k ɛ ð i n ɒ
kɛ́ðùpì	k ɛ ð ʉ p i
kɛ́ðùpí	k ɛ ð ʉ p i
kɛ́ðúrì	k ɛ ð ʉ ɹ i
kɛ́ŋɜ̀cìnɔ́	k ɛ ŋ ɐ tʃ i n ɒ
kɛ́ɽcàn	k ɛ ɹ tʃ ɑ n
kɛ́ɽìjí	k ɛ ɹ i j i
kɛ́ɾðɛ̀ðó	k ɛ ɾ ð ɛ ð ow
kɛ́ɾɔ́	k ɛ ɾ ɒ
kɛ̂	k ɛ
kɛ̂nnɛ̀	k ɛ n n ɛ
kɛ̂nɛ̀	k ɛ n ɛ
kɛ̂nɛ̌	k ɛ n ɛ
kɛ̂ɛ́	k ɛ ɛ
kɛ̌ĺɔ́ɽàt̪ɛ̀	k ɛ l ɒ ɹ ɑ t ɛ
kɛ̌ĺɔ́ɽàt̪ɛ́	k ɛ l ɒ ɹ ɑ t ɛ
kɜ̀lù	k ɐ l ʉ
kɜ̀ŋcáŋà	k ɐ ŋ tʃ ɑ ŋ ɑ
kɜ̀ŋcáŋàǎ	k ɐ ŋ tʃ ɑ ŋ ɑ ɑ
kɜ̀ŋcìjìt̪ɔ́	k ɐ ŋ tʃ i j i t ɒ
kɜ̀ŋcìjìðɔ̀t̪ɔ́	k ɐ ŋ tʃ i j i ð ɒ t ɒ
kɜ̀ŋcìjí	k ɐ ŋ tʃ i j i
kɜ̀ŋcìðìjìt̪ɔ́	k ɐ ŋ tʃ i ð i j i t ɒ
kɜ̀ŋcí	k ɐ ŋ tʃ i
kɜ̀ŋcíŋì	k ɐ ŋ tʃ i ŋ i
kɜ̀ŋcíŋìǐ	k ɐ ŋ tʃ i ŋ i i
kɜ́cí	k ɐ tʃ i
kɜ́lò	k ɐ l ow
kɜ́ló	k ɐ l ow
kɜ́lóŋò	k ɐ l ow ŋ ow
kɜ́lôŋ	k ɐ l ow ŋ
kɜ́lùŋ	k ɐ l ʉ ŋ
kɜ́lúŋò	k ɐ l ʉ ŋ ow
kɜ́lûŋ	k ɐ l ʉ ŋ
kɜ́lʊ̀	k ɐ l ʊ
kɜ́nà	k ɐ n ɑ
kɜ́ní	k ɐ n i
kɜ́rcɜ̀cì	k ɐ ɹ tʃ ɐ tʃ i
kɜ́ŋcì	k ɐ ŋ tʃ i
kɜ́ŋcíjì	k ɐ ŋ tʃ i j i
kɜ̂ŋcìjí	k ɐ ŋ tʃ i j i
kɜ̂ŋcí	k ɐ ŋ tʃ i
kɜ̌ŋcíjɔ̀	k ɐ ŋ tʃ i j ɒ
kɜ̌ŋcɔ̀	k ɐ ŋ tʃ ɒ
kɾ	k ɾ
kɾ̀ŋìt̪ɔ́	k ɾ ŋ i t ɒ
kʊ̀bùlìjí	k ʊ b ʉ l i j i
kʊ̀mbʊ́r	k ʊ m b ʊ ɹ
kʊ́blɔ́ŋnɔ̀	k ʊ b l ɒ ŋ n ɒ
kʊ́blɔ́ŋnɔ́	k ʊ b l ɒ ŋ n ɒ
kʊ́mbʊ̀r	k ʊ m b ʊ ɹ
kʊ́mʊ̀	k ʊ m ʊ
kʊ́ɽì	k ʊ ɹ i
kʊ́ɾí	k ʊ ɾ i
k̀jɔ́	k j ɒ
k̀mùt̪ɛ̀	k m ʉ t ɛ
k̀mùt̪̀nɔ́ŋ	k m ʉ t n ɒ ŋ
l	l
laì	l ɑ i
laj	l ɑ j
laŋalirlu	l ɑ ŋ ɑ l i ɹ l ʉ
là	l ɑ
làáŋì	l ɑ ɑ ŋ i
làáŋɔ̀ŋnɛ̀	l ɑ ɑ ŋ ɒ ŋ n ɛ
làbrt̪ɔ́	l ɑ b ɹ t ɒ
làbùt̪ɔ́	l ɑ b ʉ t ɒ
làbùðà	l ɑ b ʉ ð ɑ
làbùðì	l ɑ b ʉ ð i
làbùðú	l ɑ b ʉ ð ʉ
làbúlì	l ɑ b ʉ l i
làbúlìjì	l ɑ b ʉ l i j i
làbúlìjɔ̀	l ɑ b ʉ l i j ɒ
làbðò	l ɑ b ð ow
làbðɔ́	l ɑ b ð ɒ
làbə́ɽɛ̀	l ɑ b ə ɹ ɛ
làcá	l ɑ tʃ ɑ
làcíŋgɛ̀làlì	l ɑ tʃ i ŋ ɡ ɛ l ɑ l i
làcə́lì	l ɑ tʃ ə l i
làdíjà	l ɑ d i j ɑ
làdɔ̀ŋnɔ́	l ɑ d ɒ ŋ n ɒ
làdɔ́ŋnɛ̀	l ɑ d ɒ ŋ n ɛ
làdɔ́ŋðàt̪ɛ̀	l ɑ d ɒ ŋ ð ɑ t ɛ
làdɔ́ŋðɛ̀	l ɑ d ɒ ŋ ð ɛ
làd̪úɾì	l ɑ d ʉ ɾ i
làd̪úɾǐ	l ɑ d ʉ ɾ i
làd̪úɾɔ̀	l ɑ d ʉ ɾ ɒ
làgàbúð	l ɑ ɡ ɑ b ʉ ð
làgbúð	l ɑ ɡ b ʉ ð
làgɛ́cì	l ɑ ɡ ɛ tʃ i
lài	l ɑ i
làícɛ̀	l ɑ i tʃ ɛ
làídì	l ɑ i d i
làídɛ̀t̪ɛ̀	l ɑ i d ɛ t ɛ
làíjà	l ɑ i j ɑ
làíjɛ̀	l ɑ i j ɛ
làíjɛ̌	l ɑ i j ɛ
làílɔ̂ðɔ̀	l ɑ i l ɒ ð ɒ
làínd̪ɛ̀t̪ɛ̀	l ɑ i n d ɛ t ɛ
làínd̪ɛ̀t̪ɛ̌	l ɑ i n d ɛ t ɛ
làíǹd̪ɔ̀t̪ɔ́	l ɑ i n d ɒ t ɒ
làírcɛ̀cì	l ɑ i ɹ tʃ ɛ tʃ i
làít̪ɔ̀	l ɑ i t ɒ
làíðɛ̀	l ɑ i ð ɛ
làíðɛ̌	l ɑ i ð ɛ
làǐ	l ɑ i
làj	l ɑ j
làját̪ɛ̀	l ɑ j ɑ t ɛ
làjínɛ̀	l ɑ j i n ɛ
làjjà	l ɑ j j ɑ
làjlàj	l ɑ j l ɑ j
làjlàlò	l ɑ j l ɑ l ow
làjlàló	l ɑ j l ɑ l ow
làjláj	l ɑ j l ɑ j
làjlɛ́n	l ɑ j l ɛ n
làjlɜ̀lí	l ɑ j l ɐ l i
làjlɜ̀lír	l ɑ j l ɐ l i ɹ
làjú	l ɑ j ʉ
làkárcì	l ɑ k ɑ ɹ tʃ i
làkáɾì	l ɑ k ɑ ɾ i
làkéɲɛ̀	l ɑ k ɛ ɲ ɛ
làkɔ̀ðɔ́	l ɑ k ɒ ð ɒ
làkɔ́t̪ìnɛ̀	l ɑ k ɒ t i n ɛ
làkɔ́t̪ɛ̀	l ɑ k ɒ t ɛ
làkə́lcì	l ɑ k ə l tʃ i
làkɛ̀	l ɑ k ɛ
làl	l ɑ l
làlácì	l ɑ l ɑ tʃ i
làlírvə́lɛ̂ðɛ́r	l ɑ l i ɹ v ə l ɛ ð ɛ ɹ
làlírvə́lɛ̂ðɛ̌r	l ɑ l i ɹ v ə l ɛ ð ɛ ɹ
làlívə́lɛ̂ðɛ̀	l ɑ l i v ə l ɛ ð ɛ
làlívə́lɛ̂ðɛ́r	l ɑ l i v ə l ɛ ð ɛ ɹ
làlívə́lɛ̂ðɛ̌r	l ɑ l i v ə l ɛ ð ɛ ɹ
làllír	l ɑ l l i ɹ
làllírvə́lɛ̂ðɛ̌rlú	l ɑ l l i ɹ v ə l ɛ ð ɛ ɹ l ʉ
làllívə́lɛ̂ðɛ̌rlú	l ɑ l l i v ə l ɛ ð ɛ ɹ l ʉ
làllúvə́lɛ̂ðɛ̀	l ɑ l l ʉ v ə l ɛ ð ɛ
làllúvə́lɛ̂ðɛ̌rlú	l ɑ l l ʉ v ə l ɛ ð ɛ ɹ l ʉ
làllúvə́lɛ̂ðɛ̌rlúnɛ̀ɾɛ̀	l ɑ l l ʉ v ə l ɛ ð ɛ ɹ l ʉ n ɛ ɾ ɛ
làlóvə́lɛ̂ðɛ̀	l ɑ l ow v ə l ɛ ð ɛ
làlóvə́lɛ̂ðɛ́	l ɑ l ow v ə l ɛ ð ɛ
làlóvə́lɛ̂ðɛ̌	l ɑ l ow v ə l ɛ ð ɛ
làlóvə́lɛ̂ðɛ̌r	l ɑ l ow v ə l ɛ ð ɛ ɹ
làlóvə́lɛ̂ðɛ̌rló	l ɑ l ow v ə l ɛ ð ɛ ɹ l ow
làlúvə́lɛ̂ðɛ̀	l ɑ l ʉ v ə l ɛ ð ɛ
làlvə́lɛ̂ðɛ̀	l ɑ l v ə l ɛ ð ɛ
làlɔ́ɽɛ̀	l ɑ l ɒ ɹ ɛ
làlə̀ŋɔ́	l ɑ l ə ŋ ɒ
làlɛ́ŋcì	l ɑ l ɛ ŋ tʃ i
làmàcí	l ɑ m ɑ tʃ i
làmànɔ́	l ɑ m ɑ n ɒ
làmàɽðɛ̀n	l ɑ m ɑ ɹ ð ɛ n
làmàɽðɛ́n	l ɑ m ɑ ɹ ð ɛ n
làmè	l ɑ m ɛ
làmìɲí	l ɑ m i ɲ i
làmíɲɛ̀	l ɑ m i ɲ ɛ
làmút̪ə̀nɛ̀	l ɑ m ʉ t ə n ɛ
làmút̪ɛ̀	l ɑ m ʉ t ɛ
làmɔ̀nɔ́	l ɑ m ɒ n ɒ
làmɔ̀rðɔ́	l ɑ m ɒ ɹ ð ɒ
làmɔ̀rðɔ́l	l ɑ m ɒ ɹ ð ɒ l
làmə̀rðàðɔ̀	l ɑ m ə ɹ ð ɑ ð ɒ
làmə̀ɾðɔ́l	l ɑ m ə ɾ ð ɒ l
làmɛ́ðɛ̀	l ɑ m ɛ ð ɛ
làn	l ɑ n
làndì	l ɑ n d i
lànɔ́nɛ̀	l ɑ n ɒ n ɛ
lànɛ́ðɛ̀	l ɑ n ɛ ð ɛ
làpìt̪íŋì	l ɑ p i t i ŋ i
làpínɔ̀	l ɑ p i n ɒ
làpínɛ̀	l ɑ p i n ɛ
làpɔ́	l ɑ p ɒ
làpə́ɽìnɔ́	l ɑ p ə ɹ i n ɒ
làrdɔ́	l ɑ ɹ d ɒ
làrdɜ̀dì	l ɑ ɹ d ɐ d i
làré	l ɑ ɹ ɛ
làrlàló	l ɑ ɹ l ɑ l ow
làròlɛ̀	l ɑ ɹ ow l ɛ
làró	l ɑ ɹ ow
làrt̪ɔ́	l ɑ ɹ t ɒ
làrúŋì	l ɑ ɹ ʉ ŋ i
làrúŋɜ̀t̪ì	l ɑ ɹ ʉ ŋ ɐ t i
làrðɔ́	l ɑ ɹ ð ɒ
làrɔ̀	l ɑ ɹ ɒ
làrɔ̀làlír	l ɑ ɹ ɒ l ɑ l i ɹ
làrɔ̀lɜ̀lí	l ɑ ɹ ɒ l ɐ l i
làrɔ̀lɜ̀lír	l ɑ ɹ ɒ l ɐ l i ɹ
làrɛ̀	l ɑ ɹ ɛ
làrɛ́	l ɑ ɹ ɛ
làŕlànd̪ɛ̀	l ɑ ɹ l ɑ n d ɛ
làŕlɛ̀ɲì	l ɑ ɹ l ɛ ɲ i
làtóðì	l ɑ t ow ð i
làtútɛ̀	l ɑ t ʉ t ɛ
làtɛ́və́lɛ̂ðɛ̀	l ɑ t ɛ v ə l ɛ ð ɛ
làtɛ́və́lɛ̂ðɛ̌r	l ɑ t ɛ v ə l ɛ ð ɛ ɹ
làt̪íjì	l ɑ t i j i
làt̪ɔ́t̪ɛ̀	l ɑ t ɒ t ɛ
làt̪ɔ́ɽɛ̀	l ɑ t ɒ ɹ ɛ
làt̪ə́và	l ɑ t ə v ɑ
làúdì	l ɑ ʉ d i
làúd̪ɛ̀	l ɑ ʉ d ɛ
làúmə̀ðɛ̀	l ɑ ʉ m ə ð ɛ
làúrì	l ɑ ʉ ɹ i
làúrmə̀ðɛ̀	l ɑ ʉ ɹ m ə ð ɛ
làúrɛ̀t̪ɛ̀	l ɑ ʉ ɹ ɛ t ɛ
làúɽcà	l ɑ ʉ ɹ tʃ ɑ
làúɽcì	l ɑ ʉ ɹ tʃ i
làúɽìt̪ɛ̀	l ɑ ʉ ɹ i t ɛ
làúɽìðàt̪ɛ̀	l ɑ ʉ ɹ i ð ɑ t ɛ
làúɽðìðì	l ɑ ʉ ɹ ð i ð i
làvàrà	l ɑ v ɑ ɹ ɑ
làváràt̪ɛ̀	l ɑ v ɑ ɹ ɑ t ɛ
làváɾì	l ɑ v ɑ ɾ i
làvràlè	l ɑ v ɹ ɑ l ɛ
làvràlě	l ɑ v ɹ ɑ l ɛ
làvráðɛ̀	l ɑ v ɹ ɑ ð ɛ
làvŕðɛ̀	l ɑ v ɹ ð ɛ
làvŕðɛ̀t̪ɛ̀	l ɑ v ɹ ð ɛ t ɛ
làvə̀ðàcí	l ɑ v ə ð ɑ tʃ i
làvə́lɛ̀ðìnɛ̀	l ɑ v ə l ɛ ð i n ɛ
làvə́lɛ̀ðɛ̀	l ɑ v ə l ɛ ð ɛ
làvə́lɛ̂cì	l ɑ v ə l ɛ tʃ i
làvə́lɛ̂ðɛ̀	l ɑ v ə l ɛ ð ɛ
làvə́lɛ̂ðɛ̌	l ɑ v ə l ɛ ð ɛ
làvə́rlɛ̀ðɛ̀	l ɑ v ə ɹ l ɛ ð ɛ
làvɜ́ɽì	l ɑ v ɐ ɹ i
làvɜ́ɾì	l ɑ v ɐ ɾ i
làwà	l ɑ w ɑ
làwájàcì	l ɑ w ɑ j ɑ tʃ i
làwì	l ɑ w i
làwó	l ɑ w ow
làwɽíðì	l ɑ w ɹ i ð i
làðábùðà	l ɑ ð ɑ b ʉ ð ɑ
làðábùðàt̪ɔ́	l ɑ ð ɑ b ʉ ð ɑ t ɒ
làðábùðá	l ɑ ð ɑ b ʉ ð ɑ
làðábúðà	l ɑ ð ɑ b ʉ ð ɑ
làðábúðú	l ɑ ð ɑ b ʉ ð ʉ
làðánt̪ɔ̀	l ɑ ð ɑ n t ɒ
làðânt̪ɔ́	l ɑ ð ɑ n t ɒ
làðíjìnɔ̀	l ɑ ð i j i n ɒ
làðíjìnɔ̌	l ɑ ð i j i n ɒ
làðíjînɔ̀	l ɑ ð i j i n ɒ
làðírcɛ̀cí	l ɑ ð i ɹ tʃ ɛ tʃ i
làðírcɛ̀cɔ̀	l ɑ ð i ɹ tʃ ɛ tʃ ɒ
làðírcɛ̀cɔ̌	l ɑ ð i ɹ tʃ ɛ tʃ ɒ
làðíðǒ	l ɑ ð i ð ow
làðíðɔ̌	l ɑ ð i ð ɒ
làðúrú	l ɑ ð ʉ ɹ ʉ
làðúrɔ̀	l ɑ ð ʉ ɹ ɒ
làðə́dɔ̀ŋðà	l ɑ ð ə d ɒ ŋ ð ɑ
làðə́dɔ̀ŋðɔ́	l ɑ ð ə d ɒ ŋ ð ɒ
làðə́kɛ̀lcà	l ɑ ð ə k ɛ l tʃ ɑ
làðə́kɛ̀lcí	l ɑ ð ə k ɛ l tʃ i
làðə́míɲà	l ɑ ð ə m i ɲ ɑ
làðə́míɲɔ́	l ɑ ð ə m i ɲ ɒ
làðə́vr̀ðɔ̀	l ɑ ð ə v ɹ ð ɒ
làðə́vr̀ðɔ́	l ɑ ð ə v ɹ ð ɒ
làðə́və̀lɛ̀ðà	l ɑ ð ə v ə l ɛ ð ɑ
làðə́və̀lɛ̀ðɔ́	l ɑ ð ə v ə l ɛ ð ɒ
làðə́vɜ̀ɽí	l ɑ ð ə v ɐ ɹ i
làðə́vɜ̀ɽɔ̀	l ɑ ð ə v ɐ ɹ ɒ
làðɛ́là	l ɑ ð ɛ l ɑ
làðɛ́nɛ̀ðà	l ɑ ð ɛ n ɛ ð ɑ
làðɛ́nɛ̀ðɔ́	l ɑ ð ɛ n ɛ ð ɒ
làðɛ́rlɔ̀ɲɔ̀	l ɑ ð ɛ ɹ l ɒ ɲ ɒ
làðɛ́rlɛ̀ɲí	l ɑ ð ɛ ɹ l ɛ ɲ i
làðɛ́ɲɛ̀làcà	l ɑ ð ɛ ɲ ɛ l ɑ tʃ ɑ
làðɛ́ɲɛ̀làcí	l ɑ ð ɛ ɲ ɛ l ɑ tʃ i
làŋá	l ɑ ŋ ɑ
làŋácì	l ɑ ŋ ɑ tʃ i
làŋárðɛ̀	l ɑ ŋ ɑ ɹ ð ɛ
làŋáŋɛ̀	l ɑ ŋ ɑ ŋ ɛ
làŋâ	l ɑ ŋ ɑ
làŋâvə̀lɛ̀ðà	l ɑ ŋ ɑ v ə l ɛ ð ɑ
làŋâvə̀lɛ̀ðɛ̀	l ɑ ŋ ɑ v ə l ɛ ð ɛ
làŋìðàt̪ɔ́	l ɑ ŋ i ð ɑ t ɒ
làŋìðàðú	l ɑ ŋ i ð ɑ ð ʉ
làŋìðú	l ɑ ŋ i ð ʉ
làŋí	l ɑ ŋ i
làŋîvlɛ̀ðɛ̀	l ɑ ŋ i v l ɛ ð ɛ
làŋîvə̀lɛ̀ðɛ̀	l ɑ ŋ i v ə l ɛ ð ɛ
làŋlúvə́lɛ̂ðɛ̀	l ɑ ŋ l ʉ v ə l ɛ ð ɛ
làŋó	l ɑ ŋ ow
làŋt̪ìðú	l ɑ ŋ t i ð ʉ
làŋt̪ɔ́	l ɑ ŋ t ɒ
làŋt̪ɔ́l	l ɑ ŋ t ɒ l
làŋú	l ɑ ŋ ʉ
làŋɔ̀ŋnìjí	l ɑ ŋ ɒ ŋ n i j i
làŋɔ̀ŋnɔ́	l ɑ ŋ ɒ ŋ n ɒ
làŋɔ́	l ɑ ŋ ɒ
làŋɔ́l	l ɑ ŋ ɒ l
làŋɔ̂ɽàt̪ɛ̀	l ɑ ŋ ɒ ɹ ɑ t ɛ
làŋə̀l	l ɑ ŋ ə l
làŋə́l	l ɑ ŋ ə l
làŋɛ́	l ɑ ŋ ɛ
làɔ̀ŋɔ̀ŋnìjí	l ɑ ɒ ŋ ɒ ŋ n i j i
làɔ̀ŋɔ̀ŋnɔ́	l ɑ ɒ ŋ ɒ ŋ n ɒ
làɔ́ŋɔ̀ŋnìjì	l ɑ ɒ ŋ ɒ ŋ n i j i
làɔ́ŋɔ̀ŋnɛ̌	l ɑ ɒ ŋ ɒ ŋ n ɛ
làɛ́dì	l ɑ ɛ d i
làɛ́dǐ	l ɑ ɛ d i
làɛ́ɽðì	l ɑ ɛ ɹ ð i
làɟíðɜ̀cì	l ɑ dʒ i ð ɐ tʃ i
làɲɛ́làcì	l ɑ ɲ ɛ l ɑ tʃ i
làɽà	l ɑ ɹ ɑ
làɽàr	l ɑ ɹ ɑ ɹ
làɽàt̪à	l ɑ ɹ ɑ t ɑ
làɽàt̪ɔ́	l ɑ ɹ ɑ t ɒ
làɽàt̪ɛ̀	l ɑ ɹ ɑ t ɛ
làɽá	l ɑ ɹ ɑ
làɽìðú	l ɑ ɹ i ð ʉ
làɽíɲɛ̀	l ɑ ɹ i ɲ ɛ
làɽó	l ɑ ɹ ow
làɽú	l ɑ ɹ ʉ
làɽǔ	l ɑ ɹ ʉ
làɽə̀ŋàt̪ó	l ɑ ɹ ə ŋ ɑ t ow
làɽə̀ŋàt̪ǒ	l ɑ ɹ ə ŋ ɑ t ow
làɾácì	l ɑ ɾ ɑ tʃ i
làɾán	l ɑ ɾ ɑ n
làɾánɛ̀	l ɑ ɾ ɑ n ɛ
làɾánɛ́	l ɑ ɾ ɑ n ɛ
làɾân	l ɑ ɾ ɑ n
làɾò	l ɑ ɾ ow
làɾt̪á	l ɑ ɾ t ɑ
làɾt̪átɛ́	l ɑ ɾ t ɑ t ɛ
làɾt̪áŋà	l ɑ ɾ t ɑ ŋ ɑ
làɾt̪áŋǎ	l ɑ ɾ t ɑ ŋ ɑ
làɾt̪iɲarɛ	l ɑ ɾ t i ɲ ɑ ɹ ɛ
làɾt̪íŋì	l ɑ ɾ t i ŋ i
làɾt̪íŋì̌	l ɑ ɾ t i ŋ i
làɾt̪íŋí	l ɑ ɾ t i ŋ i
làɾt̪ɔ́	l ɑ ɾ t ɒ
làɾt̪ɔ́l	l ɑ ɾ t ɒ l
làɾt̪ɔ́lo	l ɑ ɾ t ɒ l ow
làɾt̪ɔ́loŋo	l ɑ ɾ t ɒ l ow ŋ ow
làɾú	l ɑ ɾ ʉ
làɾɔ̀	l ɑ ɾ ɒ
làɾɔ́	l ɑ ɾ ɒ
làɾɔ́lɛ́	l ɑ ɾ ɒ l ɛ
làɾɛ́	l ɑ ɾ ɛ
lá	l ɑ
lábrà	l ɑ b ɹ ɑ
lábrì	l ɑ b ɹ i
lábrt̪à	l ɑ b ɹ t ɑ
lábrt̪ɛ̀	l ɑ b ɹ t ɛ
lábùlìjé	l ɑ b ʉ l i j ɛ
lábùlíjé	l ɑ b ʉ l i j ɛ
lábùlú	l ɑ b ʉ l ʉ
lábùt̪ɔ́	l ɑ b ʉ t ɒ
lábúlà	l ɑ b ʉ l ɑ
lábút̪à	l ɑ b ʉ t ɑ
lábúðà	l ɑ b ʉ ð ɑ
lábûðà	l ɑ b ʉ ð ɑ
lábûðǎ	l ɑ b ʉ ð ɑ
lábə̀ɽàló	l ɑ b ə ɹ ɑ l ow
lábə̀ɽáló	l ɑ b ə ɹ ɑ l ow
lábə̀ɽɔ́	l ɑ b ə ɹ ɒ
lábə́ɽà	l ɑ b ə ɹ ɑ
lábə́ɽàlò	l ɑ b ə ɹ ɑ l ow
lábə́ɽàló	l ɑ b ə ɹ ɑ l ow
lábə́ɽǎ	l ɑ b ə ɹ ɑ
lábə́ɽɔ̀	l ɑ b ə ɹ ɒ
lácìŋgɛ̀làlí	l ɑ tʃ i ŋ ɡ ɛ l ɑ l i
lácí	l ɑ tʃ i
lácíŋgɛ̀làlà	l ɑ tʃ i ŋ ɡ ɛ l ɑ l ɑ
lácɔ̀	l ɑ tʃ ɒ
lácɔ́	l ɑ tʃ ɒ
lácə̀ló	l ɑ tʃ ə l ow
lácə́là	l ɑ tʃ ə l ɑ
ládìjɔ́	l ɑ d i j ɒ
ládíjà	l ɑ d i j ɑ
ládùɽðàt̪ɔ́	l ɑ d ʉ ɹ ð ɑ t ɒ
ládɔ̀ŋnà	l ɑ d ɒ ŋ n ɑ
ládɔ̀ŋnɔ̀	l ɑ d ɒ ŋ n ɒ
ládɔ̀ŋnɔ́	l ɑ d ɒ ŋ n ɒ
ládɔ̀ŋnɛ̀	l ɑ d ɒ ŋ n ɛ
ládɔ̀ŋðàt̪ɔ́	l ɑ d ɒ ŋ ð ɑ t ɒ
ládɔ̀ŋðɔ́	l ɑ d ɒ ŋ ð ɒ
ládɔ̀ɽðàt̪ɔ́	l ɑ d ɒ ɹ ð ɑ t ɒ
ládɔ̀ɽðɔ̀t̪ɔ́	l ɑ d ɒ ɹ ð ɒ t ɒ
ládɔ́ŋnɔ̀	l ɑ d ɒ ŋ n ɒ
ládɔ́ŋðà	l ɑ d ɒ ŋ ð ɑ
ládɔ́ŋðàt̪à	l ɑ d ɒ ŋ ð ɑ t ɑ
ládɔ́ɽðàt̪à	l ɑ d ɒ ɹ ð ɑ t ɑ
ládɔ́ɽðɔ̀t̪à	l ɑ d ɒ ɹ ð ɒ t ɑ
ládɔ̂ɽðɔ̀t̪ɔ́	l ɑ d ɒ ɹ ð ɒ t ɒ
ládɛ̀ŋnɛ̌	l ɑ d ɛ ŋ n ɛ
lád̪ùɾú	l ɑ d ʉ ɾ ʉ
lád̪úɾɔ̀	l ɑ d ʉ ɾ ɒ
lágàlàt̪ú	l ɑ ɡ ɑ l ɑ t ʉ
lágârà	l ɑ ɡ ɑ ɹ ɑ
láì	l ɑ i
láìdú	l ɑ i d ʉ
láìdɔ̀t̪ɔ́	l ɑ i d ɒ t ɒ
láìjìnɔ́	l ɑ i j i n ɒ
láìjɔ	l ɑ i j ɒ
láìjɔ́	l ɑ i j ɒ
láìnd̪ɔ̀t̪ɔ́	l ɑ i n d ɒ t ɒ
láìrcɛ̀cí	l ɑ i ɹ tʃ ɛ tʃ i
láìt̪ɔ̀t̪ɔ́	l ɑ i t ɒ t ɒ
láìt̪ɔ́	l ɑ i t ɒ
láìðɔ́	l ɑ i ð ɒ
láídɔ̀	l ɑ i d ɒ
láídɔ̀t̪ɔ̀	l ɑ i d ɒ t ɒ
láídɛ̀cà	l ɑ i d ɛ tʃ ɑ
láíjà	l ɑ i j ɑ
láílà	l ɑ i l ɑ
láínd̪ɔ̀t̪ɔ́	l ɑ i n d ɒ t ɒ
láínd̪ɔ̂t̪ɔ̀	l ɑ i n d ɒ t ɒ
láírcɔ̀	l ɑ i ɹ tʃ ɒ
láírcə̀cɔ̀	l ɑ i ɹ tʃ ə tʃ ɒ
láírcɛ̀cì	l ɑ i ɹ tʃ ɛ tʃ i
láírcɛ̀cɔ̀	l ɑ i ɹ tʃ ɛ tʃ ɒ
láírdɛ̀cɔ̀	l ɑ i ɹ d ɛ tʃ ɒ
láít̪ɔ̀t̪ɔ̀	l ɑ i t ɒ t ɒ
láíðɔ̀	l ɑ i ð ɒ
láí̀rcí	l ɑ i ɹ tʃ i
láj	l ɑ j
lájà	l ɑ j ɑ
lájàt̪ɔ́	l ɑ j ɑ t ɒ
lájáját̪à	l ɑ j ɑ j ɑ t ɑ
láját̪à	l ɑ j ɑ t ɑ
lájì	l ɑ j i
lájínò	l ɑ j i n ow
lájláj	l ɑ j l ɑ j
lájlálí	l ɑ j l ɑ l i
lájlálʊ́	l ɑ j l ɑ l ʊ
lájlɛ̀n	l ɑ j l ɛ n
lájlɛ́n	l ɑ j l ɛ n
lájlɜ́lí	l ɑ j l ɐ l i
lájlɜ́lír	l ɑ j l ɐ l i ɹ
lákàblàt̪ó	l ɑ k ɑ b l ɑ t ow
lákàcí	l ɑ k ɑ tʃ i
lákàrcí	l ɑ k ɑ ɹ tʃ i
lákàɾó	l ɑ k ɑ ɾ ow
lákárcà	l ɑ k ɑ ɹ tʃ ɑ
lákáɾà	l ɑ k ɑ ɾ ɑ
lákèɲɔ́	l ɑ k ɛ ɲ ɒ
lákéɲà	l ɑ k ɛ ɲ ɑ
lákòðɔ́	l ɑ k ow ð ɒ
lákɔ̀t̪ìnɔ́	l ɑ k ɒ t i n ɒ
lákɔ̀t̪ɔ́	l ɑ k ɒ t ɒ
lákɔ̀ðɔ́	l ɑ k ɒ ð ɒ
lákɔ́cɔ̀	l ɑ k ɒ tʃ ɒ
lákɔ́t̪à	l ɑ k ɒ t ɑ
lákɔ́t̪ǎ	l ɑ k ɒ t ɑ
lákɔ́t̪ìnɔ̀	l ɑ k ɒ t i n ɒ
lákɔ́t̪ìt̪ɔ̀	l ɑ k ɒ t i t ɒ
lákɔ́t̪ìðàt̪à	l ɑ k ɒ t i ð ɑ t ɑ
lákɔ́t̪ɔ̀t̪à	l ɑ k ɒ t ɒ t ɑ
lákɔ́t̪ɔ̀t̪ǎ	l ɑ k ɒ t ɒ t ɑ
lákɔ́t̪ɜ̀jìt̪ɔ̀	l ɑ k ɒ t ɐ j i t ɒ
lákə̀lcí	l ɑ k ə l tʃ i
lákə́lcà	l ɑ k ə l tʃ ɑ
lákɛ̀ɾɔ́	l ɑ k ɛ ɾ ɒ
lákɛ́rà	l ɑ k ɛ ɹ ɑ
lákɛ́ɾà	l ɑ k ɛ ɾ ɑ
lál	l ɑ l
lálà	l ɑ l ɑ
lálàcí	l ɑ l ɑ tʃ i
lálàɽó	l ɑ l ɑ ɹ ow
lálácà	l ɑ l ɑ tʃ ɑ
láláɽà	l ɑ l ɑ ɹ ɑ
láló	l ɑ l ow
lálóvə́lɛ̀ðà	l ɑ l ow v ə l ɛ ð ɑ
lálóvə́lɛ̂ðà	l ɑ l ow v ə l ɛ ð ɑ
lálóvə́lɛ̂ðàrló	l ɑ l ow v ə l ɛ ð ɑ ɹ l ow
lálóvə́lɛ̂ðá	l ɑ l ow v ə l ɛ ð ɑ
lálóvə́lɛ̂ðǎ	l ɑ l ow v ə l ɛ ð ɑ
lálóvə́lɛ̂ðɔ́	l ɑ l ow v ə l ɛ ð ɒ
lálùŋɔ́	l ɑ l ʉ ŋ ɒ
lálvə́lɛ̂ðɔ́	l ɑ l v ə l ɛ ð ɒ
lálɔ́ɽà	l ɑ l ɒ ɹ ɑ
lálə̀vcí	l ɑ l ə v tʃ i
lálə̀ŋɔ́	l ɑ l ə ŋ ɒ
lálə́vcà	l ɑ l ə v tʃ ɑ
lálə́ŋà	l ɑ l ə ŋ ɑ
lálə́ŋɛ̀	l ɑ l ə ŋ ɛ
lálɛ̀ŋcí	l ɑ l ɛ ŋ tʃ i
lálɛ́	l ɑ l ɛ
lálɛ́ŋcà	l ɑ l ɛ ŋ tʃ ɑ
lál̀ŋɔ́	l ɑ l ŋ ɒ
lámà	l ɑ m ɑ
lámàcà	l ɑ m ɑ tʃ ɑ
lámàcí	l ɑ m ɑ tʃ i
lámànú	l ɑ m ɑ n ʉ
lámànɔ́	l ɑ m ɑ n ɒ
lámánà	l ɑ m ɑ n ɑ
lámbr̀ðà	l ɑ m b ɹ ð ɑ
lámìðà	l ɑ m i ð ɑ
lámìɲà	l ɑ m i ɲ ɑ
lámìɲí	l ɑ m i ɲ i
lámìɲɔ́	l ɑ m i ɲ ɒ
lámíɲà	l ɑ m i ɲ ɑ
lámnà	l ɑ m n ɑ
lámràðà	l ɑ m ɹ ɑ ð ɑ
lámŕðà	l ɑ m ɹ ð ɑ
lámùt̪ɔ́	l ɑ m ʉ t ɒ
lámùt̪ə̀nɔ́	l ɑ m ʉ t ə n ɒ
lámút̪ɔ̀	l ɑ m ʉ t ɒ
lámút̪ə̀nɔ̀	l ɑ m ʉ t ə n ɒ
lámút̪ə̀nɛ̌	l ɑ m ʉ t ə n ɛ
lámɔ̀nɔ̀	l ɑ m ɒ n ɒ
lámɛ̀	l ɑ m ɛ
lámɛ̀ðɔ́	l ɑ m ɛ ð ɒ
lámɛ́ðà	l ɑ m ɛ ð ɑ
lámɛ̂ðà	l ɑ m ɛ ð ɑ
lán	l ɑ n
lánà	l ɑ n ɑ
lándà	l ɑ n d ɑ
lándě	l ɑ n d ɛ
lándì	l ɑ n d i
lánd̪ɔ̀	l ɑ n d ɒ
lánd̪ɔ́	l ɑ n d ɒ
lánt̪ɔ̀	l ɑ n t ɒ
lánɔ̀nɔ́	l ɑ n ɒ n ɒ
lánɔ́nà	l ɑ n ɒ n ɑ
lánɛ̀ðɔ́	l ɑ n ɛ ð ɒ
lánɛ́ðà	l ɑ n ɛ ð ɑ
lápà	l ɑ p ɑ
lápìnɔ́	l ɑ p i n ɒ
lápínɔ̀	l ɑ p i n ɒ
láprí	l ɑ p ɹ i
lápúɽìnɔ̀	l ɑ p ʉ ɹ i n ɒ
lápɔ̀	l ɑ p ɒ
lápɔ́	l ɑ p ɒ
lápə̀ɽìnɔ́	l ɑ p ə ɹ i n ɒ
lápə̀ɽɔ́	l ɑ p ə ɹ ɒ
lápə́ɽà	l ɑ p ə ɹ ɑ
lápə́ɽìnɔ̀	l ɑ p ə ɹ i n ɒ
lápɛ̀	l ɑ p ɛ
lárà	l ɑ ɹ ɑ
lárǎ	l ɑ ɹ ɑ
lárdà	l ɑ ɹ d ɑ
lárè	l ɑ ɹ ɛ
lárlà	l ɑ ɹ l ɑ
lárlɛ́ɲì	l ɑ ɹ l ɛ ɲ i
lárlɛ̂ɲì	l ɑ ɹ l ɛ ɲ i
lárnà	l ɑ ɹ n ɑ
lárò	l ɑ ɹ ow
láró	l ɑ ɹ ow
lárô	l ɑ ɹ ow
lárǒ	l ɑ ɹ ow
lárt̪ɔ́	l ɑ ɹ t ɒ
lárùŋɔ̀t̪ɔ́	l ɑ ɹ ʉ ŋ ɒ t ɒ
lárùŋɔ́	l ɑ ɹ ʉ ŋ ɒ
lárúŋɔ̀	l ɑ ɹ ʉ ŋ ɒ
lárúŋɔ̀t̪ɔ̀	l ɑ ɹ ʉ ŋ ɒ t ɒ
lárû	l ɑ ɹ ʉ
lárðà	l ɑ ɹ ð ɑ
lárðɛ̀	l ɑ ɹ ð ɛ
lárɔ̀	l ɑ ɹ ɒ
lárɔ̀t̪à	l ɑ ɹ ɒ t ɑ
lárɔ́	l ɑ ɹ ɒ
lárɔ́lɛ́	l ɑ ɹ ɒ l ɛ
lárɔ́ðà	l ɑ ɹ ɒ ð ɑ
lárɔ̂	l ɑ ɹ ɒ
lárɛ̀	l ɑ ɹ ɛ
lárʊ̂	l ɑ ɹ ʊ
lárʊ̌	l ɑ ɹ ʊ
lár̀d̪ɔ́	l ɑ ɹ d ɒ
lár̀lànd̪ɔ́	l ɑ ɹ l ɑ n d ɒ
láŕd̪à	l ɑ ɹ d ɑ
láŕlànd̪à	l ɑ ɹ l ɑ n d ɑ
láŕlànd̪ɛ̀	l ɑ ɹ l ɑ n d ɛ
láŕlɔ̀ɲɔ̀	l ɑ ɹ l ɒ ɲ ɒ
látùtɔ́	l ɑ t ʉ t ɒ
látútɔ̀	l ɑ t ʉ t ɒ
látɛ́və́lɛ̀ðɔ́	l ɑ t ɛ v ə l ɛ ð ɒ
látɛ́və́lɛ̂ðà	l ɑ t ɛ v ə l ɛ ð ɑ
látɛ́və́lɛ̂ðǎŕ	l ɑ t ɛ v ə l ɛ ð ɑ ɹ
látɛ́və́lɛ̂ðɔ́	l ɑ t ɛ v ə l ɛ ð ɒ
látɛ́və́lɛ̂ðɔ́r	l ɑ t ɛ v ə l ɛ ð ɒ ɹ
lát̪à	l ɑ t ɑ
lát̪ì	l ɑ t i
lát̪ó	l ɑ t ow
lát̪ɔ̀t̪ɔ́	l ɑ t ɒ t ɒ
lát̪ɔ̀ɽɔ́	l ɑ t ɒ ɹ ɒ
lát̪ɔ́t̪à	l ɑ t ɒ t ɑ
lát̪ɔ́ɽà	l ɑ t ɒ ɹ ɑ
lát̪ə́và	l ɑ t ə v ɑ
láùdí	l ɑ ʉ d i
láùd̪ɔ́	l ɑ ʉ d ɒ
láùmɔ̀ðɔ́	l ɑ ʉ m ɒ ð ɒ
láùmɔ́	l ɑ ʉ m ɒ
láùrmɛ̀ðɔ̀	l ɑ ʉ ɹ m ɛ ð ɒ
láùrù	l ɑ ʉ ɹ ʉ
láùrú	l ɑ ʉ ɹ ʉ
láùrɔ̀t̪ɔ́	l ɑ ʉ ɹ ɒ t ɒ
láùt̪ú	l ɑ ʉ t ʉ
láùɽcí	l ɑ ʉ ɹ tʃ i
láùɽìt̪ɔ́	l ɑ ʉ ɹ i t ɒ
láùɽìðàt̪ɔ́	l ɑ ʉ ɹ i ð ɑ t ɒ
láùɽðìðí	l ɑ ʉ ɹ ð i ð i
láúbðà	l ɑ ʉ b ð ɑ
láúdɔ̀	l ɑ ʉ d ɒ
láúd̪ɔ̀	l ɑ ʉ d ɒ
láúmɔ̀	l ɑ ʉ m ɒ
láúmɔ̀ðɔ̀	l ɑ ʉ m ɒ ð ɒ
láúmɔ́	l ɑ ʉ m ɒ
láúrmə̀ðɔ̀	l ɑ ʉ ɹ m ə ð ɒ
láúrmɛ̀ðɔ̀	l ɑ ʉ ɹ m ɛ ð ɒ
láúrɔ̀	l ɑ ʉ ɹ ɒ
láúrɔ̀t̪ɔ̀	l ɑ ʉ ɹ ɒ t ɒ
láúrɔ̀t̪ɔ̌	l ɑ ʉ ɹ ɒ t ɒ
láút̪à	l ɑ ʉ t ɑ
láúɽìt̪à	l ɑ ʉ ɹ i t ɑ
láúɽìt̪ɔ́	l ɑ ʉ ɹ i t ɒ
láúɽìðàt̪à	l ɑ ʉ ɹ i ð ɑ t ɑ
láúɽðìðɔ̀	l ɑ ʉ ɹ ð i ð ɒ
lávà	l ɑ v ɑ
lávàràt̪ɔ́	l ɑ v ɑ ɹ ɑ t ɒ
lávàɾó	l ɑ v ɑ ɾ ow
láváràt̪à	l ɑ v ɑ ɹ ɑ t ɑ
láváɾà	l ɑ v ɑ ɾ ɑ
lávdà	l ɑ v d ɑ
lávlà	l ɑ v l ɑ
lávlɔ́	l ɑ v l ɒ
lávràðɔ́	l ɑ v ɹ ɑ ð ɒ
lávráðà	l ɑ v ɹ ɑ ð ɑ
lávrâðà	l ɑ v ɹ ɑ ð ɑ
lávrâðǎ	l ɑ v ɹ ɑ ð ɑ
lávr̀ðɔ̀t̪ɔ́	l ɑ v ɹ ð ɒ t ɒ
lávr̀ðɔ́	l ɑ v ɹ ð ɒ
lávŕðɔ̀	l ɑ v ɹ ð ɒ
lávŕðɔ̀t̪ɔ̀	l ɑ v ɹ ð ɒ t ɒ
lávt̪à	l ɑ v t ɑ
lávə̀lɔ̀t̪ɔ́	l ɑ v ə l ɒ t ɒ
lávə̀lɛ̀ðɔ̀	l ɑ v ə l ɛ ð ɒ
lávə̀lɛ̀ðɔ́	l ɑ v ə l ɛ ð ɒ
lávə̀ðàcà	l ɑ v ə ð ɑ tʃ ɑ
lávə̀ðàcì	l ɑ v ə ð ɑ tʃ i
lávə̀ðàcí	l ɑ v ə ð ɑ tʃ i
lávə́lɔ̀t̪ɔ̀	l ɑ v ə l ɒ t ɒ
lávə́lɛ̀ðà	l ɑ v ə l ɛ ð ɑ
lávə́lɛ̀ðǎ	l ɑ v ə l ɛ ð ɑ
lávə́lɛ̂cɔ̀	l ɑ v ə l ɛ tʃ ɒ
lávə́rlɛ̀ðǎ	l ɑ v ə ɹ l ɛ ð ɑ
lávə́rlɛ̀ðɛ̀	l ɑ v ə ɹ l ɛ ð ɛ
lávɜ̀ɽí	l ɑ v ɐ ɹ i
lávɜ̀ɾó	l ɑ v ɐ ɾ ow
lávɜ́ɽɔ̀	l ɑ v ɐ ɹ ɒ
lávɜ́ɾà	l ɑ v ɐ ɾ ɑ
láv̀t̪ɔ́	l ɑ v t ɒ
láw	l ɑ w
láwà	l ɑ w ɑ
láwàjàcí	l ɑ w ɑ j ɑ tʃ i
láwájàcà	l ɑ w ɑ j ɑ tʃ ɑ
láwɽìðó	l ɑ w ɹ i ð ow
láwɽíðà	l ɑ w ɹ i ð ɑ
láðà	l ɑ ð ɑ
láðgɔ̀tà	l ɑ ð ɡ ɒ t ɑ
láðíjînɔ̀	l ɑ ð i j i n ɒ
láðùɽú	l ɑ ð ʉ ɹ ʉ
láðúɽà	l ɑ ð ʉ ɹ ɑ
láðɔ́ɽðàt̪à	l ɑ ð ɒ ɹ ð ɑ t ɑ
láðə̀ŋnɔ́l	l ɑ ð ə ŋ n ɒ l
láðə́gârà	l ɑ ð ə ɡ ɑ ɹ ɑ
láðə́và	l ɑ ð ə v ɑ
láðɛ̀	l ɑ ð ɛ
láð́	l ɑ ð
láŋà	l ɑ ŋ ɑ
láŋàló	l ɑ ŋ ɑ l ow
láŋàlú	l ɑ ŋ ɑ l ʉ
láŋàrðɔ́	l ɑ ŋ ɑ ɹ ð ɒ
láŋàt̪ɔ́	l ɑ ŋ ɑ t ɒ
láŋàŋɔ́	l ɑ ŋ ɑ ŋ ɒ
láŋácà	l ɑ ŋ ɑ tʃ ɑ
láŋálà	l ɑ ŋ ɑ l ɑ
láŋárðà	l ɑ ŋ ɑ ɹ ð ɑ
láŋátìðɔ̀	l ɑ ŋ ɑ t i ð ɒ
láŋát̪à	l ɑ ŋ ɑ t ɑ
láŋát̪ìt̪ɔ̀	l ɑ ŋ ɑ t i t ɒ
láŋát̪ìðìt̪ɔ̀	l ɑ ŋ ɑ t i ð i t ɒ
láŋát̪ɜ̀ìt̪ɔ̀	l ɑ ŋ ɑ t ɐ i t ɒ
láŋáŋà	l ɑ ŋ ɑ ŋ ɑ
láŋâlà	l ɑ ŋ ɑ l ɑ
láŋâvə̀lɛ̀ðà	l ɑ ŋ ɑ v ə l ɛ ð ɑ
láŋâvə̀lɛ̀ðǎ	l ɑ ŋ ɑ v ə l ɛ ð ɑ
láŋâð	l ɑ ŋ ɑ ð
láŋêvə̀lɛ̀ðà	l ɑ ŋ ɛ v ə l ɛ ð ɑ
láŋêvə̀lɛ̀ðǎ	l ɑ ŋ ɛ v ə l ɛ ð ɑ
láŋì	l ɑ ŋ i
láŋí	l ɑ ŋ i
láŋíðàt̪à	l ɑ ŋ i ð ɑ t ɑ
láŋíðàt̪ɛ̀	l ɑ ŋ i ð ɑ t ɛ
láŋíðì	l ɑ ŋ i ð i
láŋló	l ɑ ŋ l ow
láŋlóvə́lɛ̂ðàló	l ɑ ŋ l ow v ə l ɛ ð ɑ l ow
láŋlóvə́lɛ̂ðɔ́	l ɑ ŋ l ow v ə l ɛ ð ɒ
láŋlúvə́lɛ̂ðɛ̀	l ɑ ŋ l ʉ v ə l ɛ ð ɛ
láŋt̪à	l ɑ ŋ t ɑ
láŋt̪íðà	l ɑ ŋ t i ð ɑ
láŋt̪íðì	l ɑ ŋ t i ð i
láŋɔ̀ŋnìjì	l ɑ ŋ ɒ ŋ n i j i
láŋɔ̀ŋnìjí	l ɑ ŋ ɒ ŋ n i j i
láŋɔ̀ŋnìjɔ̀	l ɑ ŋ ɒ ŋ n i j ɒ
láŋɔ̀ŋnɔ̀	l ɑ ŋ ɒ ŋ n ɒ
láŋɔ̀ŋnɛ̌	l ɑ ŋ ɒ ŋ n ɛ
láŋə́l	l ɑ ŋ ə l
láŋə́lvə́lɛ̂ðàló	l ɑ ŋ ə l v ə l ɛ ð ɑ l ow
láɔ́bðà	l ɑ ɒ b ð ɑ
láɔ́ðà	l ɑ ɒ ð ɑ
láɛ̀ɽðó	l ɑ ɛ ɹ ð ow
láɛ́là	l ɑ ɛ l ɑ
láɛ́ɽðà	l ɑ ɛ ɹ ð ɑ
láɟìðɜ̀cí	l ɑ dʒ i ð ɐ tʃ i
láɲɛ̀làcí	l ɑ ɲ ɛ l ɑ tʃ i
láɲɛ́làcà	l ɑ ɲ ɛ l ɑ tʃ ɑ
láɽà	l ɑ ɹ ɑ
láɽàbðɔ́	l ɑ ɹ ɑ b ð ɒ
láɽàtðà	l ɑ ɹ ɑ t ð ɑ
láɽàɲìðú	l ɑ ɹ ɑ ɲ i ð ʉ
láɽá	l ɑ ɹ ɑ
láɽát̪ɛ̀	l ɑ ɹ ɑ t ɛ
láɽáɲìðà	l ɑ ɹ ɑ ɲ i ð ɑ
láɽáɲɛ̀ðà	l ɑ ɹ ɑ ɲ ɛ ð ɑ
láɽáɲɛ̂ðà	l ɑ ɹ ɑ ɲ ɛ ð ɑ
láɽâvðà	l ɑ ɹ ɑ v ð ɑ
láɽì	l ɑ ɹ i
láɽìðà	l ɑ ɹ i ð ɑ
láɽìðì	l ɑ ɹ i ð i
láɽìðú	l ɑ ɹ i ð ʉ
láɽìɲɔ́	l ɑ ɹ i ɲ ɒ
láɽíɲà	l ɑ ɹ i ɲ ɑ
láɽó	l ɑ ɹ ow
láɽû	l ɑ ɹ ʉ
láɽɔ̀t̪à	l ɑ ɹ ɒ t ɑ
láɽə̀ŋàt̪ó	l ɑ ɹ ə ŋ ɑ t ow
láɽə̀ŋàt̪ǒ	l ɑ ɹ ə ŋ ɑ t ow
láɽə̀ŋàt̪ǒr	l ɑ ɹ ə ŋ ɑ t ow ɹ
láɽə́ŋàt̪ǎ	l ɑ ɹ ə ŋ ɑ t ɑ
láɾà	l ɑ ɾ ɑ
láɾàcí	l ɑ ɾ ɑ tʃ i
láɾácà	l ɑ ɾ ɑ tʃ ɑ
láɾé	l ɑ ɾ ɛ
láɾì	l ɑ ɾ i
láɾò	l ɑ ɾ ow
láɾó	l ɑ ɾ ow
láɾô	l ɑ ɾ ow
láɾt̪ɔ́	l ɑ ɾ t ɒ
láɾt̪ɔ́l	l ɑ ɾ t ɒ l
láɾɔ́lɛ́	l ɑ ɾ ɒ l ɛ
láɾɔ́ðà	l ɑ ɾ ɒ ð ɑ
láɾɔ̂t̪ɔ̀ŋnɔ́	l ɑ ɾ ɒ t ɒ ŋ n ɒ
láɾə̀mná	l ɑ ɾ ə m n ɑ
láɾə́mnà	l ɑ ɾ ə m n ɑ
láɾɛ́	l ɑ ɾ ɛ
lâ	l ɑ
lâànt̪ɔ́	l ɑ ɑ n t ɒ
lâbró	l ɑ b ɹ ow
lâbr̀t̪ɔ́	l ɑ b ɹ t ɒ
lâbùðú	l ɑ b ʉ ð ʉ
lâbə̀ðó	l ɑ b ə ð ow
lâbə̀ðɔ́	l ɑ b ə ð ɒ
lâb̀ðɔ́	l ɑ b ð ɒ
lâd̪ùɾú	l ɑ d ʉ ɾ ʉ
lâìt̪ɔ́	l ɑ i t ɒ
lâí	l ɑ i
lâj	l ɑ j
lâjìnɔ́	l ɑ j i n ɒ
lâjjá	l ɑ j j ɑ
lâjú	l ɑ j ʉ
lâkɔ̀t̪ɔ́	l ɑ k ɒ t ɒ
lâl	l ɑ l
lâlló	l ɑ l l ow
lâlóvə́lɛ̂ðà	l ɑ l ow v ə l ɛ ð ɑ
lâlùŋɔ́	l ɑ l ʉ ŋ ɒ
lâlɔ̀ɽɔ́	l ɑ l ɒ ɹ ɒ
lâlə̀ŋɔ́	l ɑ l ə ŋ ɒ
lâmbràðɔ́	l ɑ m b ɹ ɑ ð ɒ
lâmbr̀ðɔ́	l ɑ m b ɹ ð ɒ
lâmèðɔ́	l ɑ m ɛ ð ɒ
lâmìɲí	l ɑ m i ɲ i
lâmr̀ðɔ́	l ɑ m ɹ ð ɒ
lâmɔ̀nɔ́	l ɑ m ɒ n ɒ
lâmɔ́	l ɑ m ɒ
lândó	l ɑ n d ow
lâpɔ́	l ɑ p ɒ
lârdɔ́	l ɑ ɹ d ɒ
lârlɔ́	l ɑ ɹ l ɒ
lârlɛ̀ɲí	l ɑ ɹ l ɛ ɲ i
lârnɔ́	l ɑ ɹ n ɒ
lârò	l ɑ ɹ ow
lâró	l ɑ ɹ ow
lârðɔ́	l ɑ ɹ ð ɒ
lâr̀lɔ́	l ɑ ɹ l ɒ
lâvràðó	l ɑ v ɹ ɑ ð ow
lâvràðɔ́	l ɑ v ɹ ɑ ð ɒ
lâvə̀lɛ̀cí	l ɑ v ə l ɛ tʃ i
lâv̀lɔ́	l ɑ v l ɒ
lâwó	l ɑ w ow
lâðɔ́	l ɑ ð ɒ
lâðə̀ŋnɔ́l	l ɑ ð ə ŋ n ɒ l
lâŋàcí	l ɑ ŋ ɑ tʃ i
lâŋìðàt̪ɔ́	l ɑ ŋ i ð ɑ t ɒ
lâŋìðú	l ɑ ŋ i ð ʉ
lâŋó	l ɑ ŋ ow
lâŋt̪ìðú	l ɑ ŋ t i ð ʉ
lâŋt̪ɔ́	l ɑ ŋ t ɒ
lâŋú	l ɑ ŋ ʉ
lâŋɔ̀ŋnɔ́	l ɑ ŋ ɒ ŋ n ɒ
lâɽàɽó	l ɑ ɹ ɑ ɹ ow
lâɽá	l ɑ ɹ ɑ
lâɽòt̪ɔ́	l ɑ ɹ ow t ɒ
lâɽó	l ɑ ɹ ow
lâɽɔ̀t̪ɔ́	l ɑ ɹ ɒ t ɒ
lâɾàðú	l ɑ ɾ ɑ ð ʉ
lâɾò	l ɑ ɾ ow
lâɾòðú	l ɑ ɾ ow ð ʉ
lâɾólɛ́	l ɑ ɾ ow l ɛ
lâɾù	l ɑ ɾ ʉ
lâɾɔ́	l ɑ ɾ ɒ
lǎ	l ɑ
lǎbrt̪ɛ̀	l ɑ b ɹ t ɛ
lǎbùðì	l ɑ b ʉ ð i
lǎbút̪ɛ̀	l ɑ b ʉ t ɛ
lǎìlɔ̀ðɔ́	l ɑ i l ɒ ð ɒ
lǎìt̪ɔ̀t̪ɔ́	l ɑ i t ɒ t ɒ
lǎj	l ɑ j
lǎjjà	l ɑ j j ɑ
lǎl	l ɑ l
lǎlévə́lɛ̂ðárlô	l ɑ l ɛ v ə l ɛ ð ɑ ɹ l ow
lǎlívə́lɛ̂ðárlô	l ɑ l i v ə l ɛ ð ɑ ɹ l ow
lǎlívə́lɛ̂ðɔ́	l ɑ l i v ə l ɛ ð ɒ
lǎllóvə́lɛ̂ðàló	l ɑ l l ow v ə l ɛ ð ɑ l ow
lǎllǒvə́lɛ̂ðǎ	l ɑ l l ow v ə l ɛ ð ɑ
lǎllúvə́lɛ̂ðɛ̀	l ɑ l l ʉ v ə l ɛ ð ɛ
lǎllǔvə́lɛ̂ðǎ	l ɑ l l ʉ v ə l ɛ ð ɑ
lǎllǔvə́lɛ̂ðɛ̀	l ɑ l l ʉ v ə l ɛ ð ɛ
lǎlóvə́lɛ̂ðà	l ɑ l ow v ə l ɛ ð ɑ
lǎlóvə́lɛ̂ðɔ́	l ɑ l ow v ə l ɛ ð ɒ
lǎlvə́lɛ̂ðàlò	l ɑ l v ə l ɛ ð ɑ l ow
lǎlvə́lɛ̂ðàló	l ɑ l v ə l ɛ ð ɑ l ow
lǎmàcí	l ɑ m ɑ tʃ i
lǎmànɛ̀	l ɑ m ɑ n ɛ
lǎmìɲì	l ɑ m i ɲ i
lǎmìɲǐ	l ɑ m i ɲ i
lǎmə̀ɾðà	l ɑ m ə ɾ ð ɑ
lǎndì	l ɑ n d i
lǎnt̪ɛ̀	l ɑ n t ɛ
lǎrdì	l ɑ ɹ d i
lǎt̪ì	l ɑ t i
lǎwì	l ɑ w i
lǎð	l ɑ ð
lǎŋâvlɛ̀ðɔ́	l ɑ ŋ ɑ v l ɛ ð ɒ
lǎŋíðà	l ɑ ŋ i ð ɑ
lǎŋîvlɛ̀ðɔ́	l ɑ ŋ i v l ɛ ð ɒ
lǎŋt̪ɛ̀	l ɑ ŋ t ɛ
lǎɽə̀ŋàt̪ɛ̀	l ɑ ɹ ə ŋ ɑ t ɛ
ldó	l d ow
ldú	l d ʉ
ldɔ̀	l d ɒ
ldɔ̀ŋðà	l d ɒ ŋ ð ɑ
ldɔ̀ŋðàt̪à	l d ɒ ŋ ð ɑ t ɑ
ldɔ̀ŋðàt̪ɔ́	l d ɒ ŋ ð ɑ t ɒ
ldɔ̀ŋðàt̪ɛ̀	l d ɒ ŋ ð ɑ t ɛ
ldɔ̀ŋðɛ̀	l d ɒ ŋ ð ɛ
ldɔ́	l d ɒ
ldɔ́lə́ŋâɲà	l d ɒ l ə ŋ ɑ ɲ ɑ
ldɛ̀ɾɛ̀	l d ɛ ɾ ɛ
ldɜ́rlɛ́j	l d ɐ ɹ l ɛ j
ldɜ́rlɜ̀lí	l d ɐ ɹ l ɐ l i
ld̪ùɾú	l d ʉ ɾ ʉ
ld̪ú	l d ʉ
ld̪ʊ̀ɾɔ̀t̪ɔ́	l d ʊ ɾ ɒ t ɒ
lè	l ɛ
lècə̀lò	l ɛ tʃ ə l ow
lèdé	l ɛ d ɛ
lèdéɲá	l ɛ d ɛ ɲ ɑ
lèdéɲâ	l ɛ d ɛ ɲ ɑ
lètɛ́və́lɛ̀ðà	l ɛ t ɛ v ə l ɛ ð ɑ
lèt̪ɔ́	l ɛ t ɒ
lèɲálvə́lɛ̂ðàló	l ɛ ɲ ɑ l v ə l ɛ ð ɑ l ow
lèɲálvə́lɛ̂ðɛ̀	l ɛ ɲ ɑ l v ə l ɛ ð ɛ
lèɲèlà	l ɛ ɲ ɛ l ɑ
léɲàl	l ɛ ɲ ɑ l
léɲàlɛ́və́lɛ̂ðàló	l ɛ ɲ ɑ l ɛ v ə l ɛ ð ɑ l ow
léɲál	l ɛ ɲ ɑ l
léɲálvə́lɛ̂ðàló	l ɛ ɲ ɑ l v ə l ɛ ð ɑ l ow
léɲárvə́lɛ̂ðà	l ɛ ɲ ɑ ɹ v ə l ɛ ð ɑ
léɲǎl	l ɛ ɲ ɑ l
léɲǎlvə́lɛ̂ðɛ̀	l ɛ ɲ ɑ l v ə l ɛ ð ɛ
lěɲàlvə́lɛ̂ðɔ́	l ɛ ɲ ɑ l v ə l ɛ ð ɒ
lěɲálvə́lɛ̂ðɔ́	l ɛ ɲ ɑ l v ə l ɛ ð ɒ
lěɲárvə́lɛ̀ðɔ́	l ɛ ɲ ɑ ɹ v ə l ɛ ð ɒ
liji	l i j i
lit̪rɔ	l i t ɹ ɒ
lì	l i
lìbàlɛ́n	l i b ɑ l ɛ n
lìbàlɛ́r	l i b ɑ l ɛ ɹ
lìcìlò	l i tʃ i l ow
lìcìló	l i tʃ i l ow
lìcìlɔ̀	l i tʃ i l ɒ
lìcìlɔ́	l i tʃ i l ɒ
lìclò	l i tʃ l ow
lìcò	l i tʃ ow
lìcɔ̀	l i tʃ ɒ
lìcɔ́	l i tʃ ɒ
lìcəlò	l i tʃ ə l ow
lìcə̀lá	l i tʃ ə l ɑ
lìcə̀lá̀	l i tʃ ə l ɑ
lìcə̀lò	l i tʃ ə l ow
lìcə̀ló	l i tʃ ə l ow
lìcə̀lǒ	l i tʃ ə l ow
lìcɽò	l i tʃ ɹ ow
lìdárlɛ̀j	l i d ɑ ɹ l ɛ j
lìdi	l i d i
lìdì	l i d i
lìdìjí	l i d i j i
lìdìɲà	l i d i ɲ ɑ
lìdí	l i d i
lìdjí	l i d j i
lìdú	l i d ʉ
lìdɔ̀	l i d ɒ
lìdɔ̀t̪ɔ̀	l i d ɒ t ɒ
lìdɔ̀t̪ɔ́	l i d ɒ t ɒ
lìdɛ̀t̪ɛ̀	l i d ɛ t ɛ
lìdɜ́rlɛ̀j	l i d ɐ ɹ l ɛ j
lìdɜ́rlɛ́j	l i d ɐ ɹ l ɛ j
lìdɜ́rlɛ́n	l i d ɐ ɹ l ɛ n
lìdɜ́rlɜ̀lú	l i d ɐ ɹ l ɐ l ʉ
lìdɜ́rɛ́n	l i d ɐ ɹ ɛ n
lìdɜ́rɜ́n	l i d ɐ ɹ ɐ n
lìjàjɔ̀	l i j ɑ j ɒ
lìjàrjɔ́	l i j ɑ ɹ j ɒ
lìjinɔ́	l i j i n ɒ
lìjìnɔ̀	l i j i n ɒ
lìjìnɔ́	l i j i n ɒ
lìjí	l i j i
lìjɔ́	l i j ɒ
lìjɔ̂lú	l i j ɒ l ʉ
lìlɔ̀ðɔ́	l i l ɒ ð ɒ
lìnd̪ɔ̀t̪ɔ́	l i n d ɒ t ɒ
lìrcɛ̀cí	l i ɹ tʃ ɛ tʃ i
lìrcɛ̀cɔ̀	l i ɹ tʃ ɛ tʃ ɒ
lìrdɔ̀dù	l i ɹ d ɒ d ʉ
lìrdɜ̀dù	l i ɹ d ɐ d ʉ
lìrìðɛ̀ðɛ̀	l i ɹ i ð ɛ ð ɛ
lìrlàðàðù	l i ɹ l ɑ ð ɑ ð ʉ
lìrlɜ̀ðɛ̀ðù	l i ɹ l ɐ ð ɛ ð ʉ
lìt̪iró	l i t i ɹ ow
lìt̪ìró	l i t i ɹ ow
lìt̪rɔ́	l i t ɹ ɒ
lìt̪rɛ́	l i t ɹ ɛ
lìt̪ə̀ɾɔ́	l i t ə ɾ ɒ
lìt̪ə́ɾɛ̂	l i t ə ɾ ɛ
lìt̪ɾí	l i t ɾ i
lìt̪ɾɔ̀	l i t ɾ ɒ
lìt̪ɾɔ́	l i t ɾ ɒ
lìt̪ɾɔ̌	l i t ɾ ɒ
lìvə̀lɛ̀ðɔ́l	l i v ə l ɛ ð ɒ l
lìðɔ́	l i ð ɒ
lìŋcá	l i ŋ tʃ ɑ
lìŋcáló	l i ŋ tʃ ɑ l ow
lìŋgɛ̀n	l i ŋ ɡ ɛ n
lìŋìnɔ̀	l i ŋ i n ɒ
lìɟí	l i dʒ i
lìɲárvə́lɛ̂ðɛ̀	l i ɲ ɑ ɹ v ə l ɛ ð ɛ
lìɾcɛ̀cì	l i ɾ tʃ ɛ tʃ i
lìɾcɛ̀cɔ̀	l i ɾ tʃ ɛ tʃ ɒ
lìɾìcɔ̀cɔ̀	l i ɾ i tʃ ɒ tʃ ɒ
lí	l i
lícílà	l i tʃ i l ɑ
lícɔ́	l i tʃ ɒ
lídì	l i d i
lídí	l i d i
lídǐ	l i d i
lídɔ̀	l i d ɒ
lídɔ̀ŋðɔ́	l i d ɒ ŋ ð ɒ
lídɔ́	l i d ɒ
lídɔ̂	l i d ɒ
lídɛ́rlɛ́n	l i d ɛ ɹ l ɛ n
líijà	l i i j ɑ
líjà	l i j ɑ
líjàj	l i j ɑ j
líjɔ̀	l i j ɒ
líjɔ́	l i j ɒ
líjɔ́l	l i j ɒ l
líjɔ́r	l i j ɒ ɹ
línd̪ɔ̀	l i n d ɒ
lípíjò	l i p i j ow
lípíjó	l i p i j ow
lípíjɔ́	l i p i j ɒ
lír	l i ɹ
lírà	l i ɹ ɑ
lírdɛ̀	l i ɹ d ɛ
lírdɛ̀cɔ̀	l i ɹ d ɛ tʃ ɒ
líŋcà	l i ŋ tʃ ɑ
líŋcàlò	l i ŋ tʃ ɑ l ow
líŋcàló	l i ŋ tʃ ɑ l ow
líŋgɛ́n	l i ŋ ɡ ɛ n
líɟí	l i dʒ i
líɟílìdì	l i dʒ i l i d i
líɟílìdìj̀	l i dʒ i l i d i j
líɲárvə́lɛ̀ðà	l i ɲ ɑ ɹ v ə l ɛ ð ɑ
líɾicɔ̀cɔ̀	l i ɾ i tʃ ɒ tʃ ɒ
lîcə̀lò	l i tʃ ə l ow
lǐɲálvə́lɛ̂ðɔ́	l i ɲ ɑ l v ə l ɛ ð ɒ
lǐɲárvə́lɛ̀ðɔ́	l i ɲ ɑ ɹ v ə l ɛ ð ɒ
llàcí	l l ɑ tʃ i
llàɽà	l l ɑ ɹ ɑ
llɔ̀ɽɔ́	l l ɒ ɹ ɒ
llɔ́ɽǎ	l l ɒ ɹ ɑ
lná	l n ɑ
lnə̀néj	l n ə n ɛ j
lovɜ́ɽì	l ow v ɐ ɹ i
lò	l ow
lòlà	l ow l ɑ
lòlá	l ow l ɑ
lòlò	l ow l ow
lòló	l ow l ow
lònɲà	l ow n ɲ ɑ
lòrâ	l ow ɹ ɑ
lòró	l ow ɹ ow
lòrô	l ow ɹ ow
lòtùwɛ́l	l ow t ʉ w ɛ l
lòtùwɛ́lɛ̀	l ow t ʉ w ɛ l ɛ
lòú	l ow ʉ
lòðà	l ow ð ɑ
lòðì	l ow ð i
lòɾà	l ow ɾ ɑ
lòɾá	l ow ɾ ɑ
ló	l ow
lólà	l ow l ɑ
lóló	l ow l ow
lómàn	l ow m ɑ n
lómǎn	l ow m ɑ n
lórá	l ow ɹ ɑ
lótùwɛ́l	l ow t ʉ w ɛ l
lóðà	l ow ð ɑ
lrlɛ̀ɲíl	l ɹ l ɛ ɲ i l
lrɔ́bà	l ɹ ɒ b ɑ
lrɔ̂bà	l ɹ ɒ b ɑ
lrə̀mt̪ù	l ɹ ə m t ʉ
lrə̀mt̪ɛ̀n	l ɹ ə m t ɛ n
lr̀	l ɹ
lr̀lɛ̀ɲì	l ɹ l ɛ ɲ i
lr̀lɛ̀ɲí	l ɹ l ɛ ɲ i
lr̀lɛ̀ɲíl	l ɹ l ɛ ɲ i l
lŕlɛ̀ɲíl	l ɹ l ɛ ɲ i l
lŕrɔ̀ðɔ̀	l ɹ ɹ ɒ ð ɒ
lŕrɔ̀ðɔ́r	l ɹ ɹ ɒ ð ɒ ɹ
lŕrɔ̀ðɔ̌	l ɹ ɹ ɒ ð ɒ
ltuwɛ́l	l t ʉ w ɛ l
ltùwɛ́l	l t ʉ w ɛ l
ltùwɛ́lɛ́	l t ʉ w ɛ l ɛ
ltúm	l t ʉ m
ltúwɛ́l	l t ʉ w ɛ l
ltɔ̀	l t ɒ
ltɔ́	l t ɒ
ltʊ́	l t ʊ
ltʊ̌	l t ʊ
lt̪ɔ̀t̪à	l t ɒ t ɑ
lt̪ɔ̀t̪ɛ̀	l t ɒ t ɛ
lt̪ɔ́t̪à	l t ɒ t ɑ
lu	l ʉ
lurnɔ	l ʉ ɹ n ɒ
lùbà	l ʉ b ɑ
lùbút̪ú	l ʉ b ʉ t ʉ
lùbút̪ɛ̀	l ʉ b ʉ t ɛ
lùb̀tú	l ʉ b t ʉ
lùdí	l ʉ d i
lùdɔ́	l ʉ d ɒ
lùd̪ɔ́	l ʉ d ɒ
lùmìnɔ́	l ʉ m i n ɒ
lùmìnɔ̌	l ʉ m i n ɒ
lùmnɔ̀	l ʉ m n ɒ
lùmɔ̀ðɔ̀ðɔ̀	l ʉ m ɒ ð ɒ ð ɒ
lùmɔ̀ðɔ́	l ʉ m ɒ ð ɒ
lùnéj	l ʉ n ɛ j
lùnɔ̀	l ʉ n ɒ
lùnɛ́j	l ʉ n ɛ j
lùò	l ʉ ow
lùpìɽíl	l ʉ p i ɹ i l
lùrì	l ʉ ɹ i
lùrìjɔ̀	l ʉ ɹ i j ɒ
lùrìjɔ́	l ʉ ɹ i j ɒ
lùrìjɔ̌	l ʉ ɹ i j ɒ
lùrmɔ̀ðɔ̀ðɔ̀	l ʉ ɹ m ɒ ð ɒ ð ɒ
lùrnɔ	l ʉ ɹ n ɒ
lùrnɔ̀	l ʉ ɹ n ɒ
lùró	l ʉ ɹ ow
lùrù	l ʉ ɹ ʉ
lùrú	l ʉ ɹ ʉ
lùrɔ̀	l ʉ ɹ ɒ
lùrɔ̀t̪ɔ̀	l ʉ ɹ ɒ t ɒ
lùrɔ̀t̪ɔ́	l ʉ ɹ ɒ t ɒ
lùrɛ̀t̪ɛ̀	l ʉ ɹ ɛ t ɛ
lùtùwò	l ʉ t ʉ w ow
lùtùwɔ̀	l ʉ t ʉ w ɒ
lùt̪ùlá	l ʉ t ʉ l ɑ
lùt̪ùlú	l ʉ t ʉ l ʉ
lùɽbí	l ʉ ɹ b i
lùɽbɔ̀	l ʉ ɹ b ɒ
lùɽbɔ́	l ʉ ɹ b ɒ
lùɽcà	l ʉ ɹ tʃ ɑ
lùɽcì	l ʉ ɹ tʃ i
lùɽcí	l ʉ ɹ tʃ i
lùɽìt̪à	l ʉ ɹ i t ɑ
lùɽìt̪ɔ́	l ʉ ɹ i t ɒ
lùɽìt̪ɛ̀	l ʉ ɹ i t ɛ
lùɽìðà	l ʉ ɹ i ð ɑ
lùɽìðàt̪ɔ́	l ʉ ɹ i ð ɑ t ɒ
lùɽìðì	l ʉ ɹ i ð i
lùɽìðó	l ʉ ɹ i ð ow
lùɽìðù	l ʉ ɹ i ð ʉ
lùɽìðú	l ʉ ɹ i ð ʉ
lùɽùvɔ̀	l ʉ ɹ ʉ v ɒ
lùɽùvɔ́	l ʉ ɹ ʉ v ɒ
lùɽví	l ʉ ɹ v i
lùɽɟénɛ́	l ʉ ɹ dʒ ɛ n ɛ
lùɾìjɔ́	l ʉ ɾ i j ɒ
lú	l ʉ
lúbútɛ́	l ʉ b ʉ t ɛ
lúcɔ́	l ʉ tʃ ɒ
lúcɔ̂	l ʉ tʃ ɒ
lúgɔ̀	l ʉ ɡ ɒ
lúgɔ́	l ʉ ɡ ɒ
lúmán	l ʉ m ɑ n
lúmɔ́n	l ʉ m ɒ n
lúmɔ́ná	l ʉ m ɒ n ɑ
lúó	l ʉ ow
lúrì	l ʉ ɹ i
lúrnɔ̀	l ʉ ɹ n ɒ
lúrnɔ́	l ʉ ɹ n ɒ
lúrnɔ̌	l ʉ ɹ n ɒ
lúrɔ̀	l ʉ ɹ ɒ
lútw	l ʉ t w
lúwɔ́	l ʉ w ɒ
lúɔ̀	l ʉ ɒ
lúɔ́	l ʉ ɒ
lúɽìðàt̪à	l ʉ ɹ i ð ɑ t ɑ
lúɽìðàt̪ɛ̀	l ʉ ɹ i ð ɑ t ɛ
lúɽvɔ́	l ʉ ɹ v ɒ
lúɾnɔ́	l ʉ ɾ n ɒ
lûd̪ɔ́	l ʉ d ɒ
lɔmɔðɛ	l ɒ m ɒ ð ɛ
lɔmɛ	l ɒ m ɛ
lɔ̀bìðì	l ɒ b i ð i
lɔ̀bìðí	l ɒ b i ð i
lɔ̀bɛ̀ɽá	l ɒ b ɛ ɹ ɑ
lɔ̀dɔ́	l ɒ d ɒ
lɔ̀gtár	l ɒ ɡ t ɑ ɹ
lɔ̀là	l ɒ l ɑ
lɔ̀mɔ	l ɒ m ɒ
lɔ̀mɔ̀	l ɒ m ɒ
lɔ̀mɔ̀lɛ̀	l ɒ m ɒ l ɛ
lɔ̀mɔ̀ðɛ̀	l ɒ m ɒ ð ɛ
lɔ̀mɔ̀ðɛ́	l ɒ m ɒ ð ɛ
lɔ̀n	l ɒ n
lɔ̀rà	l ɒ ɹ ɑ
lɔ̀rlà	l ɒ ɹ l ɑ
lɔ̀rlàló	l ɒ ɹ l ɑ l ow
lɔ̀rláj	l ɒ ɹ l ɑ j
lɔ̀rlɜ̀li	l ɒ ɹ l ɐ l i
lɔ̀rlɜ̀lír	l ɒ ɹ l ɐ l i ɹ
lɔ̀rɔ́	l ɒ ɹ ɒ
lɔ̀t̪á	l ɒ t ɑ
lɔ̀t̪ɔ̀	l ɒ t ɒ
lɔ̀t̪ɔ́	l ɒ t ɒ
lɔ̀ɲà	l ɒ ɲ ɑ
lɔ̀ɲɔ̀	l ɒ ɲ ɒ
lɔ̀ɲɔ́	l ɒ ɲ ɒ
lɔ̀ɽàt̪áŋà	l ɒ ɹ ɑ t ɑ ŋ ɑ
lɔ̀ɽàt̪íŋì	l ɒ ɹ ɑ t i ŋ i
lɔ̀ɽàt̪íŋí	l ɒ ɹ ɑ t i ŋ i
lɔ̀ɽàt̪íŋǐ	l ɒ ɹ ɑ t i ŋ i
lɔ̀ɽàt̪ɔ́	l ɒ ɹ ɑ t ɒ
lɔ̀ɽá	l ɒ ɹ ɑ
lɔ̀ɽɔ̀t̪ɔ́	l ɒ ɹ ɒ t ɒ
lɔ̀ɽɔ́	l ɒ ɹ ɒ
lɔ̀ɽɟɛ̀cí	l ɒ ɹ dʒ ɛ tʃ i
lɔ̀ɽɟɛ̀n	l ɒ ɹ dʒ ɛ n
lɔ̀ɽɟɛ̌n	l ɒ ɹ dʒ ɛ n
lɔ́	l ɒ
lɔ́bðà	l ɒ b ð ɑ
lɔ́bɛ́ɽá	l ɒ b ɛ ɹ ɑ
lɔ́bɛ́ɽɛ́	l ɒ b ɛ ɹ ɛ
lɔ́cɔ̀	l ɒ tʃ ɒ
lɔ́cɔ́	l ɒ tʃ ɒ
lɔ́dà	l ɒ d ɑ
lɔ́dâ	l ɒ d ɑ
lɔ́dɔ́	l ɒ d ɒ
lɔ́dɛ̀	l ɒ d ɛ
lɔ́mán	l ɒ m ɑ n
lɔ́mɔ̀	l ɒ m ɒ
lɔ́mɔ̀ðɛ̀	l ɒ m ɒ ð ɛ
lɔ́mɔ́n	l ɒ m ɒ n
lɔ́mɔ́nɛ̀	l ɒ m ɒ n ɛ
lɔ́mɔ́nɛ́	l ɒ m ɒ n ɛ
lɔ́mɔ̌	l ɒ m ɒ
lɔ́mɛ̀	l ɒ m ɛ
lɔ́mɛ́	l ɒ m ɛ
lɔ́n	l ɒ n
lɔ́rà	l ɒ ɹ ɑ
lɔ́rá	l ɒ ɹ ɑ
lɔ́rɔ́	l ɒ ɹ ɒ
lɔ́t̪ɔ̀	l ɒ t ɒ
lɔ́t̪ɔ̀t̪ɔ́	l ɒ t ɒ t ɒ
lɔ́t̪ɔ́t̪à	l ɒ t ɒ t ɑ
lɔ́vɛ́ɽá	l ɒ v ɛ ɹ ɑ
lɔ́vɛ́ɽɛ́	l ɒ v ɛ ɹ ɛ
lɔ́w	l ɒ w
lɔ́ðà	l ɒ ð ɑ
lɔ́ðɔ́	l ɒ ð ɒ
lɔ́ɟàn	l ɒ dʒ ɑ n
lɔ́ɟɔ̀	l ɒ dʒ ɒ
lɔ́ɽà	l ɒ ɹ ɑ
lɔ́ɽàgə̀ðú	l ɒ ɹ ɑ ɡ ə ð ʉ
lɔ́ɽàt̪ɛ̀	l ɒ ɹ ɑ t ɛ
lɔ́ɽàt̪ɛ̌	l ɒ ɹ ɑ t ɛ
lɔ́ɽǎ	l ɒ ɹ ɑ
lɔ́ɽɔ̀gɔ̀ðɔ́	l ɒ ɹ ɒ ɡ ɒ ð ɒ
lɔ́ɽɔ̀ðɔ́	l ɒ ɹ ɒ ð ɒ
lɔ́ɽɔ́	l ɒ ɹ ɒ
lɔ́ɽɛ̀	l ɒ ɹ ɛ
lɔ́ɽɟɛ̀cà	l ɒ ɹ dʒ ɛ tʃ ɑ
lɔ́ɽɟɛ́nɛ́	l ɒ ɹ dʒ ɛ n ɛ
lɔ́ɾɔ́	l ɒ ɾ ɒ
lɔ̂dɔ́	l ɒ d ɒ
lɔ̂n	l ɒ n
lɔ̂ń	l ɒ n
lɔ̂t̪ɔ́	l ɒ t ɒ
lɔ̂ɽɟɛ̀cí	l ɒ ɹ dʒ ɛ tʃ i
lɔ̌t̪ɔ́ɽǎ	l ɒ t ɒ ɹ ɑ
lɔ̌w	l ɒ w
lɔ̌ɽàt̪ɛ̀	l ɒ ɹ ɑ t ɛ
lɔ̌ɽìt̪ɛ̀	l ɒ ɹ i t ɛ
lɔ̌ɽɟɛ̀cì	l ɒ ɹ dʒ ɛ tʃ i
lə	l ə
ləvə̀lɛ̀ðɔ́lə́ŋʊ	l ə v ə l ɛ ð ɒ l ə ŋ ʊ
ləvə̀lɛ̀ðɛ̀	l ə v ə l ɛ ð ɛ
ləvə́r	l ə v ə ɹ
lə̀béj	l ə b ɛ j
lə̀bò	l ə b ow
lə̀bó	l ə b ow
lə̀bùlìjíl	l ə b ʉ l i j i l
lə̀bútù	l ə b ʉ t ʉ
lə̀bɔ̀lɔ̀	l ə b ɒ l ɒ
lə̀bə̀lɛ́j	l ə b ə l ɛ j
lə̀bə̀ɽáló	l ə b ə ɹ ɑ l ow
lə̀bə̀ɽɔ́	l ə b ə ɹ ɒ
lə̀bɛ́n	l ə b ɛ n
lə̀bɜ̀lú	l ə b ɐ l ʉ
lə̀bɽálò	l ə b ɹ ɑ l ow
lə̀bɽɔ̀ðìðú	l ə b ɹ ɒ ð i ð ʉ
lə̀bʊ̀	l ə b ʊ
lə̀bʊ́	l ə b ʊ
lə̀cìlà	l ə tʃ i l ɑ
lə̀cìŋgìlàlà	l ə tʃ i ŋ ɡ i l ɑ l ɑ
lə̀cìŋgìlàlì	l ə tʃ i ŋ ɡ i l ɑ l i
lə̀cə̀lá	l ə tʃ ə l ɑ
lə̀dárlɛ̀j	l ə d ɑ ɹ l ɛ j
lə̀dɔɽðɔ̀t̪ɔ́	l ə d ɒ ɹ ð ɒ t ɒ
lə̀dɔ̀ŋðɔ́	l ə d ɒ ŋ ð ɒ
lə̀dɔ́	l ə d ɒ
lə̀dɜ́rlèlú	l ə d ɐ ɹ l ɛ l ʉ
lə̀dɜ́rlɜ̀lír	l ə d ɐ ɹ l ɐ l i ɹ
lə̀dɜ́rlɜ̀lú	l ə d ɐ ɹ l ɐ l ʉ
lə̀d̪ɔ̀	l ə d ɒ
lə̀d̪ɛ̀ɾɛ́	l ə d ɛ ɾ ɛ
lə̀d̪ɛ́ɾɛ́	l ə d ɛ ɾ ɛ
lə̀gàró	l ə ɡ ɑ ɹ ow
lə̀gwɔ̀t̪ɔ́	l ə ɡ w ɒ t ɒ
lə̀gɔ̀tɔ́	l ə ɡ ɒ t ɒ
lə̀jàrjɔ́	l ə j ɑ ɹ j ɒ
lə̀kàrcí	l ə k ɑ ɹ tʃ i
lə̀kèɲɔ́	l ə k ɛ ɲ ɒ
lə̀kìðɔ́	l ə k i ð ɒ
lə̀kɔ̀tɔ́	l ə k ɒ t ɒ
lə̀kɔ̀t̪ìnɔ̀	l ə k ɒ t i n ɒ
lə̀kɔ̀t̪ìnɛ̀	l ə k ɒ t i n ɛ
lə̀kɔ̀t̪ɔ̀t̪ɔ́	l ə k ɒ t ɒ t ɒ
lə̀kɔ̀t̪ɔ́	l ə k ɒ t ɒ
lə̀kə̀lcà	l ə k ə l tʃ ɑ
lə̀kə̀lcì	l ə k ə l tʃ i
lə̀kɛ̀lcà	l ə k ɛ l tʃ ɑ
lə̀kɛ̀lcì	l ə k ɛ l tʃ i
lə̀mànàló	l ə m ɑ n ɑ l ow
lə̀mànɛ́n	l ə m ɑ n ɛ n
lə̀màð	l ə m ɑ ð
lə̀màðáj	l ə m ɑ ð ɑ j
lə̀mbrá	l ə m b ɹ ɑ
lə̀mèðɔ́	l ə m ɛ ð ɒ
lə̀mìɲɔ́	l ə m i ɲ ɒ
lə̀mùðɛ̀	l ə m ʉ ð ɛ
lə̀mɔ̀ð	l ə m ɒ ð
lə̀mɔ̀ðá	l ə m ɒ ð ɑ
lə̀mɔ̀ðâ	l ə m ɒ ð ɑ
lə̀mɔ̀ðɛ̀	l ə m ɒ ð ɛ
lə̀mɔ́	l ə m ɒ
lə̀mɔ́ð	l ə m ɒ ð
lə̀mɛ̀rðàðìt̪ɔ̀	l ə m ɛ ɹ ð ɑ ð i t ɒ
lə̀mɛ̀ðàðɔ̀	l ə m ɛ ð ɑ ð ɒ
lə̀mɛ̀ðɔ́	l ə m ɛ ð ɒ
lə̀nà	l ə n ɑ
lə̀ndó	l ə n d ow
lə̀nɔ́	l ə n ɒ
lə̀nɛ̀	l ə n ɛ
lə̀nɛ̀ðɔ́	l ə n ɛ ð ɒ
lə̀p	l ə p
lə̀pàpìðú	l ə p ɑ p i ð ʉ
lə̀pìnɔ́	l ə p i n ɒ
lə̀pɔ̀	l ə p ɒ
lə̀pɔ́	l ə p ɒ
lə̀pɔ́l	l ə p ɒ l
lə̀pɛ̀	l ə p ɛ
lə̀pɛ́r	l ə p ɛ ɹ
lə̀r	l ə ɹ
lə̀rà	l ə ɹ ɑ
lə̀rá	l ə ɹ ɑ
lə̀rdà	l ə ɹ d ɑ
lə̀rdì	l ə ɹ d i
lə̀rè	l ə ɹ ɛ
lə̀ré	l ə ɹ ɛ
lə̀rì	l ə ɹ i
lə̀rí	l ə ɹ i
lə̀rǐ	l ə ɹ i
lə̀rlànd̪ɔ́	l ə ɹ l ɑ n d ɒ
lə̀rlɛ̀ɲì	l ə ɹ l ɛ ɲ i
lə̀rlɛ̀ɲɔ̀	l ə ɹ l ɛ ɲ ɒ
lə̀ró	l ə ɹ ow
lə̀rùŋú	l ə ɹ ʉ ŋ ʉ
lə̀rɔ̀ðɔ̀	l ə ɹ ɒ ð ɒ
lə̀rə̀r	l ə ɹ ə ɹ
lə̀rɽìɲàɲɔ̀	l ə ɹ ɹ i ɲ ɑ ɲ ɒ
lə̀rɽìɲàɲɔ́	l ə ɹ ɹ i ɲ ɑ ɲ ɒ
lə̀tòðó	l ə t ow ð ow
lə̀tùtɔ́	l ə t ʉ t ɒ
lə̀túm	l ə t ʉ m
lə̀t̪à	l ə t ɑ
lə̀t̪ì	l ə t i
lə̀t̪ìjí	l ə t i j i
lə̀t̪ó	l ə t ow
lə̀t̪rì	l ə t ɹ i
lə̀t̪ɔ́	l ə t ɒ
lə̀t̪ə̀rvàvɔ̀	l ə t ə ɹ v ɑ v ɒ
lə̀t̪ə̀vɔ́	l ə t ə v ɒ
lə̀t̪ə̀vɛ̀	l ə t ə v ɛ
lə̀t̪ə́vɛ̀	l ə t ə v ɛ
lə̀t̪ə́vɛ̀ŕ	l ə t ə v ɛ ɹ
lə̀t̪ɾì	l ə t ɾ i
lə̀t̪ɾɔ̀	l ə t ɾ ɒ
lə̀ùrt̪ɔ̀t̪ɔ̀	l ə ʉ ɹ t ɒ t ɒ
lə̀ùrɔ̀t̪ɔ̀t̪ɔ̀	l ə ʉ ɹ ɒ t ɒ t ɒ
lə̀vàrà	l ə v ɑ ɹ ɑ
lə̀vàràt̪à	l ə v ɑ ɹ ɑ t ɑ
lə̀vàràt̪ɔ́	l ə v ɑ ɹ ɑ t ɒ
lə̀vàràt̪ɛ̀	l ə v ɑ ɹ ɑ t ɛ
lə̀vàrt̪ù	l ə v ɑ ɹ t ʉ
lə̀vàrvàrɔ̀	l ə v ɑ ɹ v ɑ ɹ ɒ
lə̀vàvrà	l ə v ɑ v ɹ ɑ
lə̀vàvràɛ́lɔ́	l ə v ɑ v ɹ ɑ ɛ l ɒ
lə̀vàvrì	l ə v ɑ v ɹ i
lə̀vàvɾà	l ə v ɑ v ɾ ɑ
lə̀vàvɾǎ	l ə v ɑ v ɾ ɑ
lə̀vàvɾì	l ə v ɑ v ɾ i
lə̀vàɾà	l ə v ɑ ɾ ɑ
lə̀vàɾì	l ə v ɑ ɾ i
lə̀vàɾó	l ə v ɑ ɾ ow
lə̀vcá	l ə v tʃ ɑ
lə̀vcí	l ə v tʃ i
lə̀vé	l ə v ɛ
lə̀vlɛ̀ðɔ̂lló	l ə v l ɛ ð ɒ l l ow
lə̀vrà	l ə v ɹ ɑ
lə̀vràðɔ́	l ə v ɹ ɑ ð ɒ
lə̀vrǎ	l ə v ɹ ɑ
lə̀vr̀ðàt̪ɔ̀	l ə v ɹ ð ɑ t ɒ
lə̀vr̀ðàt̪ɔ́	l ə v ɹ ð ɑ t ɒ
lə̀vr̀ðàt̪ɛ̀	l ə v ɹ ð ɑ t ɛ
lə̀vr̀ðɔ̀	l ə v ɹ ð ɒ
lə̀vr̀ðɔ́	l ə v ɹ ð ɒ
lə̀vr̀ðɛ̀	l ə v ɹ ð ɛ
lə̀vr̀ðɛ̀t̪ɛ̀	l ə v ɹ ð ɛ t ɛ
lə̀vŕ	l ə v ɹ
lə̀və̀lɛ̀cì	l ə v ə l ɛ tʃ i
lə̀və̀lɛ̀cɔ̀	l ə v ə l ɛ tʃ ɒ
lə̀və̀lɛ̀ðà	l ə v ə l ɛ ð ɑ
lə̀və̀lɛ̀ðálér	l ə v ə l ɛ ð ɑ l ɛ ɹ
lə̀və̀lɛ̀ðálérló	l ə v ə l ɛ ð ɑ l ɛ ɹ l ow
lə̀və̀lɛ̀ðálěrló	l ə v ə l ɛ ð ɑ l ɛ ɹ l ow
lə̀və̀lɛ̀ðálí	l ə v ə l ɛ ð ɑ l i
lə̀və̀lɛ̀ðálír	l ə v ə l ɛ ð ɑ l i ɹ
lə̀və̀lɛ̀ðálírló	l ə v ə l ɛ ð ɑ l i ɹ l ow
lə̀və̀lɛ̀ðálírlô	l ə v ə l ɛ ð ɑ l i ɹ l ow
lə̀və̀lɛ̀ðálló	l ə v ə l ɛ ð ɑ l l ow
lə̀və̀lɛ̀ðáló	l ə v ə l ɛ ð ɑ l ow
lə̀və̀lɛ̀ðálɔ́ŋʊ́	l ə v ə l ɛ ð ɑ l ɒ ŋ ʊ
lə̀və̀lɛ̀ðálɔ́ŋʊ̂	l ə v ə l ɛ ð ɑ l ɒ ŋ ʊ
lə̀və̀lɛ̀ðátɛ̀	l ə v ə l ɛ ð ɑ t ɛ
lə̀və̀lɛ̀ðátɛ́	l ə v ə l ɛ ð ɑ t ɛ
lə̀və̀lɛ̀ðátɛ́r	l ə v ə l ɛ ð ɑ t ɛ ɹ
lə̀və̀lɛ̀ðáŋà	l ə v ə l ɛ ð ɑ ŋ ɑ
lə̀və̀lɛ̀ðáɲàl	l ə v ə l ɛ ð ɑ ɲ ɑ l
lə̀və̀lɛ̀ðáɲàló	l ə v ə l ɛ ð ɑ ɲ ɑ l ow
lə̀və̀lɛ̀ðáɲál	l ə v ə l ɛ ð ɑ ɲ ɑ l
lə̀və̀lɛ̀ðáɲáló	l ə v ə l ɛ ð ɑ ɲ ɑ l ow
lə̀və̀lɛ̀ðáɲǎl	l ə v ə l ɛ ð ɑ ɲ ɑ l
lə̀və̀lɛ̀ðâlló	l ə v ə l ɛ ð ɑ l l ow
lə̀və̀lɛ̀ðìnɔ́	l ə v ə l ɛ ð i n ɒ
lə̀və̀lɛ̀ðɔ́	l ə v ə l ɛ ð ɒ
lə̀və̀lɛ̀ðɔ́l	l ə v ə l ɛ ð ɒ l
lə̀və̀lɛ̀ðɔ́lóŋgó	l ə v ə l ɛ ð ɒ l ow ŋ ɡ ow
lə̀və̀lɛ̀ðɔ́lóŋò	l ə v ə l ɛ ð ɒ l ow ŋ ow
lə̀və̀lɛ̀ðɔ́lóŋó	l ə v ə l ɛ ð ɒ l ow ŋ ow
lə̀və̀lɛ̀ðɔ́lŋó	l ə v ə l ɛ ð ɒ l ŋ ow
lə̀və̀lɛ̀ðɔ́lŋô	l ə v ə l ɛ ð ɒ l ŋ ow
lə̀və̀lɛ̀ðɔ́lŋù	l ə v ə l ɛ ð ɒ l ŋ ʉ
lə̀və̀lɛ̀ðɔ́lə́ŋʊ̀	l ə v ə l ɛ ð ɒ l ə ŋ ʊ
lə̀və̀lɛ̀ðɔ́rà	l ə v ə l ɛ ð ɒ ɹ ɑ
lə̀və̀lɛ̀ðɔ́ŋóló	l ə v ə l ɛ ð ɒ ŋ ow l ow
lə̀və̀lɛ̀ðɔ̂llú	l ə v ə l ɛ ð ɒ l l ʉ
lə̀və̀lɛ̀ðɛ̀	l ə v ə l ɛ ð ɛ
lə̀və̀lɛ̀ðɛ́	l ə v ə l ɛ ð ɛ
lə̀və̀lɛ̀ðɛ́l	l ə v ə l ɛ ð ɛ l
lə̀və̀lɛ̀ðɛ́ló	l ə v ə l ɛ ð ɛ l ow
lə̀və̀lɛ̀ðɛ́lù	l ə v ə l ɛ ð ɛ l ʉ
lə̀və̀lɛ̀ðɛ́lú	l ə v ə l ɛ ð ɛ l ʉ
lə̀və̀lɛ̀ðɛ́ŋì	l ə v ə l ɛ ð ɛ ŋ i
lə̀və̀lɛ̀ðɛ́ɲárɛ́	l ə v ə l ɛ ð ɛ ɲ ɑ ɹ ɛ
lə̀və̀lɛ̀ðɛ̌	l ə v ə l ɛ ð ɛ
lə̀və̀lɛ̀ðɜ́ló	l ə v ə l ɛ ð ɐ l ow
lə̀və̀lɛ̀ðɜ̂lló	l ə v ə l ɛ ð ɐ l l ow
lə̀və̀lɛ̀ðɜ̂llú	l ə v ə l ɛ ð ɐ l l ʉ
lə̀və̀lɛ̀ðɜ̂ló	l ə v ə l ɛ ð ɐ l ow
lə̀və̀r	l ə v ə ɹ
lə̀və̀rlɛ̀ðɔ́	l ə v ə ɹ l ɛ ð ɒ
lə̀və́lɛ̀ðà	l ə v ə l ɛ ð ɑ
lə̀və́lɛ̀ðàŕ	l ə v ə l ɛ ð ɑ ɹ
lə̀və́lɛ̀ðɛ̀	l ə v ə l ɛ ð ɛ
lə̀və́lɛ̀ðɛ̀ŕ	l ə v ə l ɛ ð ɛ ɹ
lə̀və́r	l ə v ə ɹ
lə̀və́rá	l ə v ə ɹ ɑ
lə̀və́râ	l ə v ə ɹ ɑ
lə̀vɛ̀lɛ̀ðɔ́	l ə v ɛ l ɛ ð ɒ
lə̀vɛ̀r	l ə v ɛ ɹ
lə̀vɛ́r	l ə v ɛ ɹ
lə̀vɛ̌r	l ə v ɛ ɹ
lə̀vɜ̀ɽì	l ə v ɐ ɹ i
lə̀vɜ̀ɽí	l ə v ɐ ɹ i
lə̀vɜ̀ɽɔ̀	l ə v ɐ ɹ ɒ
lə̀vɜ̀ɾó	l ə v ɐ ɾ ow
lə̀vɾà	l ə v ɾ ɑ
lə̀wàjà	l ə w ɑ j ɑ
lə̀wàjàcà	l ə w ɑ j ɑ tʃ ɑ
lə̀wàjàcì	l ə w ɑ j ɑ tʃ i
lə̀wàjàcí	l ə w ɑ j ɑ tʃ i
lə̀wàjì	l ə w ɑ j i
lə̀ðɔ̀ŋ	l ə ð ɒ ŋ
lə̀ðɔ̀ŋɔ̀	l ə ð ɒ ŋ ɒ
lə̀ðɔ́	l ə ð ɒ
lə̀ðə̀rɲɔ̀ɲɔ́	l ə ð ə ɹ ɲ ɒ ɲ ɒ
lə̀ŋàcí	l ə ŋ ɑ tʃ i
lə̀ŋàrðɔ́	l ə ŋ ɑ ɹ ð ɒ
lə̀ŋàŋà	l ə ŋ ɑ ŋ ɑ
lə̀ŋàŋɛ̀	l ə ŋ ɑ ŋ ɛ
lə̀ɟìðɔ̀cɔ̀	l ə dʒ i ð ɒ tʃ ɒ
lə̀ɟìðɜ̀cì	l ə dʒ i ð ɐ tʃ i
lə̀ɟìðɜ̀cí	l ə dʒ i ð ɐ tʃ i
lə̀ɽà	l ə ɹ ɑ
lə̀ɽá	l ə ɹ ɑ
lə̀ɽávrè	l ə ɹ ɑ v ɹ ɛ
lə̀ɾàcí	l ə ɾ ɑ tʃ i
lə̀ɾə̀mnà	l ə ɾ ə m n ɑ
lə̀ɾə̀mná	l ə ɾ ə m n ɑ
lə́bò	l ə b ow
lə́bó	l ə b ow
lə́bô	l ə b ow
lə́bǒ	l ə b ow
lə́bʊ̀	l ə b ʊ
lə́bʊ́	l ə b ʊ
lə́gàràt̪ɔ́l	l ə ɡ ɑ ɹ ɑ t ɒ l
lə́gàró	l ə ɡ ɑ ɹ ow
lə́gàrór	l ə ɡ ɑ ɹ ow ɹ
lə́gàrɔ̀lɛ́	l ə ɡ ɑ ɹ ɒ l ɛ
lə́gàɾàtíŋí	l ə ɡ ɑ ɾ ɑ t i ŋ i
lə́gáɾíŋí	l ə ɡ ɑ ɾ i ŋ i
lə́mɔ̀ðɛ̀	l ə m ɒ ð ɛ
lə́mɔ̀ðɛ́	l ə m ɒ ð ɛ
lə́píjɔ́	l ə p i j ɒ
lə́r̀lànd̪ɔ́	l ə ɹ l ɑ n d ɒ
lə́tà	l ə t ɑ
lə́t̪ə́vàŕ	l ə t ə v ɑ ɹ
lə́t̪ə́vɛ̀	l ə t ə v ɛ
lə́t̪ə́vɛ̀ŕ	l ə t ə v ɛ ɹ
lə́vàrt̪ù	l ə v ɑ ɹ t ʉ
lə́vàvrà	l ə v ɑ v ɹ ɑ
lə́vàvrǎ	l ə v ɑ v ɹ ɑ
lə́vàvrì	l ə v ɑ v ɹ i
lə́vàvrǐ	l ə v ɑ v ɹ i
lə́vàvɾà	l ə v ɑ v ɾ ɑ
lə́vàvɾǎ	l ə v ɑ v ɾ ɑ
lə́vcì	l ə v tʃ i
lə́vcí	l ə v tʃ i
lə́vəlɔ́	l ə v ə l ɒ
lə́və̀lɛ̀ðɛ̀	l ə v ə l ɛ ð ɛ
lə́və̀lɛ̀ðɛ̀r	l ə v ə l ɛ ð ɛ ɹ
lə́və̀r	l ə v ə ɹ
lə́və́lɛ̀ðà	l ə v ə l ɛ ð ɑ
lə́və́lɛ̀ðàŕ	l ə v ə l ɛ ð ɑ ɹ
lə́və́lɛ̀ðɛ̀	l ə v ə l ɛ ð ɛ
lə́və́lɛ̀ðɛ̀ŕ	l ə v ə l ɛ ð ɛ ɹ
lə́və́r	l ə v ə ɹ
lə́ŋáŋà	l ə ŋ ɑ ŋ ɑ
lə́ŋicà	l ə ŋ i tʃ ɑ
lə́ɽà	l ə ɹ ɑ
lɛ	l ɛ
lɛjja	l ɛ j j ɑ
lɛ̀	l ɛ
lɛ̀ànt̪ɔ́	l ɛ ɑ n t ɒ
lɛ̀àrdɛ̀dì	l ɛ ɑ ɹ d ɛ d i
lɛ̀bùlìjí	l ɛ b ʉ l i j i
lɛ̀bùlìjɛ́	l ɛ b ʉ l i j ɛ
lɛ̀bùlíjí	l ɛ b ʉ l i j i
lɛ̀bùlú	l ɛ b ʉ l ʉ
lɛ̀bɔ̀lɔ́	l ɛ b ɒ l ɒ
lɛ̀bɔ̀lɛ	l ɛ b ɒ l ɛ
lɛ̀cìŋgɛ̀làlí	l ɛ tʃ i ŋ ɡ ɛ l ɑ l i
lɛ̀clò	l ɛ tʃ l ow
lɛ̀cə̀lò	l ɛ tʃ ə l ow
lɛ̀dè	l ɛ d ɛ
lɛ̀dé	l ɛ d ɛ
lɛ̀dì	l ɛ d i
lɛ̀dí	l ɛ d i
lɛ̀dùrì	l ɛ d ʉ ɹ i
lɛ̀dùrɔ̀	l ɛ d ʉ ɹ ɒ
lɛ̀dɛ̀	l ɛ d ɛ
lɛ̀dɛ́	l ɛ d ɛ
lɛ̀dɛ́ɲâ	l ɛ d ɛ ɲ ɑ
lɛ̀dɛ̌	l ɛ d ɛ
lɛ̀dɜ̀dì	l ɛ d ɐ d i
lɛ̀d̪ùɾú	l ɛ d ʉ ɾ ʉ
lɛ̀d̪ùɾɔ̀t̪ɔ́	l ɛ d ʉ ɾ ɒ t ɒ
lɛ̀d̪ɛ̀ɾé	l ɛ d ɛ ɾ ɛ
lɛ̀gàɾó	l ɛ ɡ ɑ ɾ ow
lɛ̀gàɾɛ́ɲì	l ɛ ɡ ɑ ɾ ɛ ɲ i
lɛ̀gàɾɛ́ɲí	l ɛ ɡ ɑ ɾ ɛ ɲ i
lɛ̀gɔ̀t̪ìnɔ́	l ɛ ɡ ɒ t i n ɒ
lɛ̀ìlɔ̀ðɔ́	l ɛ i l ɒ ð ɒ
lɛ̀jàt̪ɔ́	l ɛ j ɑ t ɒ
lɛ̀jjà	l ɛ j j ɑ
lɛ̀kàkàrɔ̀	l ɛ k ɑ k ɑ ɹ ɒ
lɛ̀kàrkàrɔ̀	l ɛ k ɑ ɹ k ɑ ɹ ɒ
lɛ̀kàɾó	l ɛ k ɑ ɾ ow
lɛ̀kìɲàt̪ɔ́	l ɛ k i ɲ ɑ t ɒ
lɛ̀kìɲàt̪ɔ́l	l ɛ k i ɲ ɑ t ɒ l
lɛ̀kɔ̀t̪ìnɔ́	l ɛ k ɒ t i n ɒ
lɛ̀kɔ̀t̪ɔ̀t̪ɔ́	l ɛ k ɒ t ɒ t ɒ
lɛ̀kɔ̀t̪ɔ́	l ɛ k ɒ t ɒ
lɛ̀kə̀lcí	l ɛ k ə l tʃ i
lɛ̀kɜ̀rcɜ̀cí	l ɛ k ɐ ɹ tʃ ɐ tʃ i
lɛ̀lívə́lɛ̂ðɛ́r	l ɛ l i v ə l ɛ ð ɛ ɹ
lɛ̀lvə́lɛ̂ðɛ̀	l ɛ l v ə l ɛ ð ɛ
lɛ̀lvə́lɛ̂ðɛ̀lʊ̀	l ɛ l v ə l ɛ ð ɛ l ʊ
lɛ̀lvə́lɛ̂ðɛ́	l ɛ l v ə l ɛ ð ɛ
lɛ̀lɛ̀ŋcí	l ɛ l ɛ ŋ tʃ i
lɛ̀lɛ̀ŋìt̪ɔ́l	l ɛ l ɛ ŋ i t ɒ l
lɛ̀màɽðɛ́n	l ɛ m ɑ ɹ ð ɛ n
lɛ̀màɽðɛ́ná	l ɛ m ɑ ɹ ð ɛ n ɑ
lɛ̀má	l ɛ m ɑ
lɛ̀mbrâ	l ɛ m b ɹ ɑ
lɛ̀mbré	l ɛ m b ɹ ɛ
lɛ̀mbrɛ̀	l ɛ m b ɹ ɛ
lɛ̀mbrɛ́	l ɛ m b ɹ ɛ
lɛ̀mùt̪ìnɔ́	l ɛ m ʉ t i n ɒ
lɛ̀mùt̪ɔ̀	l ɛ m ʉ t ɒ
lɛ̀mùt̪ɔ́	l ɛ m ʉ t ɒ
lɛ̀mùt̪ɛ̀	l ɛ m ʉ t ɛ
lɛ̀mùðɛ̀	l ɛ m ʉ ð ɛ
lɛ̀mùðɛ́	l ɛ m ʉ ð ɛ
lɛ̀mùðɛ̌	l ɛ m ʉ ð ɛ
lɛ̀mɛ̀rðàðìnt̪ɔ̀	l ɛ m ɛ ɹ ð ɑ ð i n t ɒ
lɛ̀mɛ̀ðɔ́	l ɛ m ɛ ð ɒ
lɛ̀mɛ́	l ɛ m ɛ
lɛ̀nɔ̀nɔ́	l ɛ n ɒ n ɒ
lɛ̀nɛ̀	l ɛ n ɛ
lɛ̀nɛ̀nɛ́j	l ɛ n ɛ n ɛ j
lɛ̀nɛ̀ðɔ́	l ɛ n ɛ ð ɒ
lɛ̀nɛ́	l ɛ n ɛ
lɛ̀nɛ̌	l ɛ n ɛ
lɛ̀pìnɔ́	l ɛ p i n ɒ
lɛ̀rá	l ɛ ɹ ɑ
lɛ̀râ	l ɛ ɹ ɑ
lɛ̀rdɔ́	l ɛ ɹ d ɒ
lɛ̀ré	l ɛ ɹ ɛ
lɛ̀rlànd̪àd̪ɔ̀	l ɛ ɹ l ɑ n d ɑ d ɒ
lɛ̀rlànd̪ɔ́	l ɛ ɹ l ɑ n d ɒ
lɛ̀rlɛ̀ɲí	l ɛ ɹ l ɛ ɲ i
lɛ̀rùŋɔ̀t̪ɔ́	l ɛ ɹ ʉ ŋ ɒ t ɒ
lɛ̀rəcàcì̀	l ɛ ɹ ə tʃ ɑ tʃ i
lɛ̀rə̀mnà	l ɛ ɹ ə m n ɑ
lɛ̀rə̀mná	l ɛ ɹ ə m n ɑ
lɛ̀tɛ́və́lɛ̀ðà	l ɛ t ɛ v ə l ɛ ð ɑ
lɛ̀tɛ́və́lɛ̀ðàŕ	l ɛ t ɛ v ə l ɛ ð ɑ ɹ
lɛ̀t̪ìmí	l ɛ t i m i
lɛ̀t̪ɔ̀t̪ɔ́	l ɛ t ɒ t ɒ
lɛ̀t̪ɔ̀ɽɔ́	l ɛ t ɒ ɹ ɒ
lɛ̀ùmɔ̀ðɔ̀ðɔ̀	l ɛ ʉ m ɒ ð ɒ ð ɒ
lɛ̀ùrmùðɔ́	l ɛ ʉ ɹ m ʉ ð ɒ
lɛ̀ùrmɔ̀ðɔ̀ðɔ̀	l ɛ ʉ ɹ m ɒ ð ɒ ð ɒ
lɛ̀ùɽìt̪ɔ́	l ɛ ʉ ɹ i t ɒ
lɛ̀ùɽðìðí	l ɛ ʉ ɹ ð i ð i
lɛ̀vàɾt̪ɔ̀	l ɛ v ɑ ɾ t ɒ
lɛ̀və̀lɛ̀cí	l ɛ v ə l ɛ tʃ i
lɛ̀və̀lɛ̀ðà	l ɛ v ə l ɛ ð ɑ
lɛ̀və̀lɛ̀ðáló	l ɛ v ə l ɛ ð ɑ l ow
lɛ̀və̀lɛ̀ðɔ́	l ɛ v ə l ɛ ð ɒ
lɛ̀vɛ̀r	l ɛ v ɛ ɹ
lɛ̀vɛ́r	l ɛ v ɛ ɹ
lɛ̀vɛ̌ɾ	l ɛ v ɛ ɾ
lɛ̀vɜ̀rɽɜ̀ɽì	l ɛ v ɐ ɹ ɹ ɐ ɹ i
lɛ̀vɜ̀rɽɜ̀ɽí	l ɛ v ɐ ɹ ɹ ɐ ɹ i
lɛ̀ðíjìnɔ̀	l ɛ ð i j i n ɒ
lɛ̀ðíjînɔ̀	l ɛ ð i j i n ɒ
lɛ̀ŋàcí	l ɛ ŋ ɑ tʃ i
lɛ̀ŋàt̪ɔ́	l ɛ ŋ ɑ t ɒ
lɛ̀ŋàŋɔ́	l ɛ ŋ ɑ ŋ ɒ
lɛ̀ŋcà	l ɛ ŋ tʃ ɑ
lɛ̀ŋcá	l ɛ ŋ tʃ ɑ
lɛ̀ŋcíŋì	l ɛ ŋ tʃ i ŋ i
lɛ̀ŋgài	l ɛ ŋ ɡ ɑ i
lɛ̀ŋgàló	l ɛ ŋ ɡ ɑ l ow
lɛ̀ŋgái	l ɛ ŋ ɡ ɑ i
lɛ̀ŋgáí	l ɛ ŋ ɡ ɑ i
lɛ̀ŋgáj	l ɛ ŋ ɡ ɑ j
lɛ̀ŋgɛ̀lí	l ɛ ŋ ɡ ɛ l i
lɛ̀ŋgɛ̀lír	l ɛ ŋ ɡ ɛ l i ɹ
lɛ̀ŋgɛ̀n	l ɛ ŋ ɡ ɛ n
lɛ̀ŋgɛ̀ň	l ɛ ŋ ɡ ɛ n
lɛ̀ŋgɛ́n	l ɛ ŋ ɡ ɛ n
lɛ̀ŋîvə̀lɛ̀ðà	l ɛ ŋ i v ə l ɛ ð ɑ
lɛ̀ə̀rlànd̪ɔ́	l ɛ ə ɹ l ɑ n d ɒ
lɛ̀ɲ	l ɛ ɲ
lɛ̀ɲɛ̀làcí	l ɛ ɲ ɛ l ɑ tʃ i
lɛ̀ɲɛ̀làcílíŋú	l ɛ ɲ ɛ l ɑ tʃ i l i ŋ ʉ
lɛ̀ɽàɲìðɔ́	l ɛ ɹ ɑ ɲ i ð ɒ
lɛ̀ɽàɲìðɔ̌	l ɛ ɹ ɑ ɲ i ð ɒ
lɛ̀ɽánó	l ɛ ɹ ɑ n ow
lɛ̀ɽìɲɔ́	l ɛ ɹ i ɲ ɒ
lɛ̀ɽðó	l ɛ ɹ ð ow
lɛ́	l ɛ
lɛ́dɔ̀ŋðɔ́	l ɛ d ɒ ŋ ð ɒ
lɛ́dɛ́ɲâ	l ɛ d ɛ ɲ ɑ
lɛ́gàrɔ̀lɛ́	l ɛ ɡ ɑ ɹ ɒ l ɛ
lɛ́gàɾàt̪íŋí	l ɛ ɡ ɑ ɾ ɑ t i ŋ i
lɛ́jìnɔ̀	l ɛ j i n ɒ
lɛ́là	l ɛ l ɑ
lɛ́làrú	l ɛ l ɑ ɹ ʉ
lɛ́lá	l ɛ l ɑ
lɛ́láj	l ɛ l ɑ j
lɛ́láló	l ɛ l ɑ l ow
lɛ́lvélɛ̂ðà	l ɛ l v ɛ l ɛ ð ɑ
lɛ́lvə́lɛ̂ðà	l ɛ l v ə l ɛ ð ɑ
lɛ́lvə́lɛ̂ðàlo	l ɛ l v ə l ɛ ð ɑ l ow
lɛ́lvə́lɛ̂ðàlò	l ɛ l v ə l ɛ ð ɑ l ow
lɛ́lvə́lɛ̂ðàló	l ɛ l v ə l ɛ ð ɑ l ow
lɛ́lvə́lɛ̂ðàlǒ	l ɛ l v ə l ɛ ð ɑ l ow
lɛ́lvə́lɛ̂ðɔ̀	l ɛ l v ə l ɛ ð ɒ
lɛ́lvə́lɛ̂ðɔ́	l ɛ l v ə l ɛ ð ɒ
lɛ́lvə́lɛ̂ðɔ́lo	l ɛ l v ə l ɛ ð ɒ l ow
lɛ́lvə́lɛ̂ðɛ̀	l ɛ l v ə l ɛ ð ɛ
lɛ́lvə́lɛ̂ðɛ̀lo	l ɛ l v ə l ɛ ð ɛ l ow
lɛ́lɔ̀ðɔ̀	l ɛ l ɒ ð ɒ
lɛ́lɔ́ɽǎ	l ɛ l ɒ ɹ ɑ
lɛ́lɛ́lí	l ɛ l ɛ l i
lɛ́lɛ́lír	l ɛ l ɛ l i ɹ
lɛ́lɛ́n	l ɛ l ɛ n
lɛ́màð	l ɛ m ɑ ð
lɛ́màɽðén	l ɛ m ɑ ɹ ð ɛ n
lɛ́mǎð	l ɛ m ɑ ð
lɛ́mbrà	l ɛ m b ɹ ɑ
lɛ́mbrɛ̀	l ɛ m b ɹ ɛ
lɛ́mùðɛ̀	l ɛ m ʉ ð ɛ
lɛ́mùðɛ́	l ɛ m ʉ ð ɛ
lɛ́n	l ɛ n
lɛ́nê	l ɛ n ɛ
lɛ́ngɛ́n	l ɛ n ɡ ɛ n
lɛ́nnê	l ɛ n n ɛ
lɛ́nně	l ɛ n n ɛ
lɛ́nɛ̀	l ɛ n ɛ
lɛ́nɛ̌	l ɛ n ɛ
lɛ́rà	l ɛ ɹ ɑ
lɛ́ré	l ɛ ɹ ɛ
lɛ́rɔ̀ðɔ̀	l ɛ ɹ ɒ ð ɒ
lɛ́rɛ́	l ɛ ɹ ɛ
lɛ́t̪ɛ̀	l ɛ t ɛ
lɛ́vlɛ̀ðɔ́lŋù	l ɛ v l ɛ ð ɒ l ŋ ʉ
lɛ́ðɛ́t̪ɛ̀n	l ɛ ð ɛ t ɛ n
lɛ́ŋàɲà	l ɛ ŋ ɑ ɲ ɑ
lɛ́ŋâɲà	l ɛ ŋ ɑ ɲ ɑ
lɛ́ŋcí	l ɛ ŋ tʃ i
lɛ́ŋgáí	l ɛ ŋ ɡ ɑ i
lɛ́ŋgáj	l ɛ ŋ ɡ ɑ j
lɛ́ŋgálí	l ɛ ŋ ɡ ɑ l i
lɛ́ŋgálír	l ɛ ŋ ɡ ɑ l i ɹ
lɛ́ŋgáló	l ɛ ŋ ɡ ɑ l ow
lɛ́ŋgɛ̀n	l ɛ ŋ ɡ ɛ n
lɛ́ŋgɛ̀nà	l ɛ ŋ ɡ ɛ n ɑ
lɛ́ŋgɛ̀ň	l ɛ ŋ ɡ ɛ n
lɛ́ŋgɛ́lí	l ɛ ŋ ɡ ɛ l i
lɛ́ŋgɛ́n	l ɛ ŋ ɡ ɛ n
lɛ́ŋgɛ́nâ	l ɛ ŋ ɡ ɛ n ɑ
lɛ́ŋgɜ́lí	l ɛ ŋ ɡ ɐ l i
lɛ́ŋ̀gɛ́n	l ɛ ŋ ɡ ɛ n
lɛ́ɲ	l ɛ ɲ
lɛ́ɲɛ̀	l ɛ ɲ ɛ
lɛ́ɲɛ́	l ɛ ɲ ɛ
lɛ̂	l ɛ
lɛ̂ré	l ɛ ɹ ɛ
lɛ̂ŋcí	l ɛ ŋ tʃ i
lɛ̂ŋgɛ̀n	l ɛ ŋ ɡ ɛ n
lɛ̂ŋgɛ́n	l ɛ ŋ ɡ ɛ n
lɛ̂ŋgɛ̌n	l ɛ ŋ ɡ ɛ n
lɛ̂ɛ́	l ɛ ɛ
lɛ̌	l ɛ
lɛ̌cɛ̀	l ɛ tʃ ɛ
lɛ̌lívə́lɛ̂ðà	l ɛ l i v ə l ɛ ð ɑ
lɛ̌lívə́lɛ̂ðárlô	l ɛ l i v ə l ɛ ð ɑ ɹ l ow
lɛ̌lívə́lɛ̂ðɔ̀	l ɛ l i v ə l ɛ ð ɒ
lɛ̌lvə́lɛ̂ðɔ́	l ɛ l v ə l ɛ ð ɒ
lɛ̌ɲ	l ɛ ɲ
lɜ̀	l ɐ
lɜ̀lívə́lɛ̂ðɛ̀	l ɐ l i v ə l ɛ ð ɛ
lɜ̀llívlðɛ̌rlú	l ɐ l l i v l ð ɛ ɹ l ʉ
lɜ̀llívə́lɛ̂ðɛ̌rlù	l ɐ l l i v ə l ɛ ð ɛ ɹ l ʉ
lɜ̀llívə́lɛ̂ðɛ̌rlú	l ɐ l l i v ə l ɛ ð ɛ ɹ l ʉ
lɜ̀llúvə́lɛ̂ðɛ̀	l ɐ l l ʉ v ə l ɛ ð ɛ
lɜ̀ù	l ɐ ʉ
lɜ̀ŋcìðú	l ɐ ŋ tʃ i ð ʉ
lɜ̀ŋcí	l ɐ ŋ tʃ i
lɜ̀ŋcíŋì	l ɐ ŋ tʃ i ŋ i
lɜ̀ŋí	l ɐ ŋ i
lɜ̀ɟíðɜ̀cì	l ɐ dʒ i ð ɐ tʃ i
lɜ́dúɾɔ̀	l ɐ d ʉ ɾ ɒ
lɜ́d̪úɾɔ̀	l ɐ d ʉ ɾ ɒ
lɜ́lívə́lɛ̂ðárlô	l ɐ l i v ə l ɛ ð ɑ ɹ l ow
lɜ́lívə́lɛ̂ðɔ́	l ɐ l i v ə l ɛ ð ɒ
lɜ́lívə́lɛ̂ðɔ́rlɔ́	l ɐ l i v ə l ɛ ð ɒ ɹ l ɒ
lɜ́lvə́lɛ̂ðɔ́	l ɐ l v ə l ɛ ð ɒ
lɜ́ndì	l ɐ n d i
lɜ́nt̪ɛ̀	l ɐ n t ɛ
lɜ́ó	l ɐ ow
lɜ́vɜ̀ɽí	l ɐ v ɐ ɹ i
lɜ́w	l ɐ w
lɜ́ŋcì	l ɐ ŋ tʃ i
lɜ́ŋcíðì	l ɐ ŋ tʃ i ð i
lɜ́ŋcíðɔ̀	l ɐ ŋ tʃ i ð ɒ
lɜ́ɜ̀ŋcí	l ɐ ɐ ŋ tʃ i
lɜ́ɟíðɔ̀cɔ̀	l ɐ dʒ i ð ɒ tʃ ɒ
lɜ̂ŋcí	l ɐ ŋ tʃ i
lɜ̌lérvə́lɛ̂ðárlô	l ɐ l ɛ ɹ v ə l ɛ ð ɑ ɹ l ow
lɜ̌lévə́lɛ̂ðárlô	l ɐ l ɛ v ə l ɛ ð ɑ ɹ l ow
lɜ̌lívə́lɛ̂ðárlô	l ɐ l i v ə l ɛ ð ɑ ɹ l ow
lɜ̌lívə́lɛ̂ðɔ́	l ɐ l i v ə l ɛ ð ɒ
lɜ̌rcɛ̀cì	l ɐ ɹ tʃ ɛ tʃ i
lɜ̌ŋcì	l ɐ ŋ tʃ i
lɜ̌ŋcɔ̀	l ɐ ŋ tʃ ɒ
lɟí	l dʒ i
lɽàɲìðɔ́	l ɹ ɑ ɲ i ð ɒ
lɽìɲɔ́	l ɹ i ɲ ɒ
lɾàcí	l ɾ ɑ tʃ i
lʊbu	l ʊ b ʉ
lʊ̀cɔ̀	l ʊ tʃ ɒ
lʊ̀dó	l ʊ d ow
lʊ̀tù	l ʊ t ʉ
lʊ̀tú	l ʊ t ʉ
lʊ̀tʊ̀	l ʊ t ʊ
lʊ̀tʊ́	l ʊ t ʊ
lʊ̀tʊ̂ʊ́	l ʊ t ʊ ʊ
lʊ̀tʊ̌	l ʊ t ʊ
lʊ́bʊ̀	l ʊ b ʊ
lʊ́dʊ̀	l ʊ d ʊ
lʊ́mbɛ̀	l ʊ m b ɛ
lʊ́mbɛ́	l ʊ m b ɛ
l̀dɔ̀ŋðɔ́	l d ɒ ŋ ð ɒ
l̀twɛ̀l	l t w ɛ l
l̀tɾì	l t ɾ i
l̀t̪rì	l t ɹ i
l̀t̪ɾì	l t ɾ i
l̀t̪ɾɔ̀	l t ɾ ɒ
ĺdòɾɲà	l d ow ɾ ɲ ɑ
ĺdòɾɲǎ	l d ow ɾ ɲ ɑ
ĺdóɾɲà	l d ow ɾ ɲ ɑ
ĺdóɾɲâ	l d ow ɾ ɲ ɑ
ĺnà	l n ɑ
màðìnù	m ɑ ð i n ʉ
màɽù	m ɑ ɹ ʉ
mánú	m ɑ n ʉ
márà	m ɑ ɹ ɑ
máɽðìnɔ̀	m ɑ ɹ ð i n ɒ
méðɔ́	m ɛ ð ɒ
mìɲàt̪á	m i ɲ ɑ t ɑ
mìɲá	m i ɲ ɑ
mìɲɔ̀	m i ɲ ɒ
míɲà	m i ɲ ɑ
míɲàt̪ɛ̀	m i ɲ ɑ t ɛ
míɲát̪ɔ́	m i ɲ ɑ t ɒ
míɲɔ́	m i ɲ ɒ
mna	m n ɑ
mnà	m n ɑ
mòvé	m ow v ɛ
mùt̪ùnɔ́	m ʉ t ʉ n ɒ
mùt̪ɔ̀	m ʉ t ɒ
mùt̪ɔ́	m ʉ t ɒ
mùt̪ə̀nɔ́	m ʉ t ə n ɒ
mùðù	m ʉ ð ʉ
mùðú	m ʉ ð ʉ
mùðǔ	m ʉ ð ʉ
mùðɔ̀	m ʉ ð ɒ
mút̪ɔ́	m ʉ t ɒ
mút̪ə́nɔ́	m ʉ t ə n ɒ
mút̪ə́nɔ̂	m ʉ t ə n ɒ
múðù	m ʉ ð ʉ
múðɔ̀	m ʉ ð ɒ
múðɔ́	m ʉ ð ɒ
múðɔ̌	m ʉ ð ɒ
mŋ̀ðií	m ŋ ð i i
mɔ̀	m ɒ
mɔ̀lɔ̀	m ɒ l ɒ
mɔ̀rðɔ́	m ɒ ɹ ð ɒ
mɔ́nɔ́	m ɒ n ɒ
mə̀nà	m ə n ɑ
mə́ɲát̪ɔ́	m ə ɲ ɑ t ɒ
mɛ̀	m ɛ
mɛ̀ðá	m ɛ ð ɑ
mɛ́rðàðè	m ɛ ɹ ð ɑ ð ɛ
mɛ́rðàðìnt̪ɛ̀	m ɛ ɹ ð ɑ ð i n t ɛ
mɛ́rðàðìt̪ɛ̀	m ɛ ɹ ð ɑ ð i t ɛ
mɛ́rðàðɔ̀	m ɛ ɹ ð ɑ ð ɒ
mɛ́rðàðɛ̀	m ɛ ɹ ð ɑ ð ɛ
mɛ́ðàðì	m ɛ ð ɑ ð i
mɛ́ðát̪á	m ɛ ð ɑ t ɑ
mɛ́ðát̪ɔ́	m ɛ ð ɑ t ɒ
mɛ́ðɔ́	m ɛ ð ɒ
mɜ́ðínò	m ɐ ð i n ow
mɜ́ðɔ́	m ɐ ð ɒ
ḿɲât̪ɛ̀	m ɲ ɑ t ɛ
n	n
navda	n ɑ v d ɑ
nà	n ɑ
nàdám	n ɑ d ɑ m
nàdámà	n ɑ d ɑ m ɑ
nàdámá	n ɑ d ɑ m ɑ
nàì	n ɑ i
nàíjǎ	n ɑ i j ɑ
nàj	n ɑ j
nàjèné	n ɑ j ɛ n ɛ
nàjènɛ̀	n ɑ j ɛ n ɛ
nàjén	n ɑ j ɛ n
nàjì	n ɑ j i
nàjínò	n ɑ j i n ow
nàjínɔ̀	n ɑ j i n ɒ
nàjɛ́n	n ɑ j ɛ n
nàl	n ɑ l
nàlbàcʊ́mɛ́	n ɑ l b ɑ tʃ ʊ m ɛ
nàlbàcʊ̂m	n ɑ l b ɑ tʃ ʊ m
nàlbríð	n ɑ l b ɹ i ð
nàlcʊ̀mú	n ɑ l tʃ ʊ m ʉ
nàlgàlgàrájɛ̀	n ɑ l ɡ ɑ l ɡ ɑ ɹ ɑ j ɛ
nàlkárò	n ɑ l k ɑ ɹ ow
nàlmúndù	n ɑ l m ʉ n d ʉ
nàlmúnd̪ɔ̀	n ɑ l m ʉ n d ɒ
nàlðàlgàrájɛ̀	n ɑ l ð ɑ l ɡ ɑ ɹ ɑ j ɛ
nàlðàlgàrájɛ́	n ɑ l ð ɑ l ɡ ɑ ɹ ɑ j ɛ
nàmàð	n ɑ m ɑ ð
nàmáð	n ɑ m ɑ ð
nàmìðí	n ɑ m i ð i
nàmɽárɛ̀	n ɑ m ɹ ɑ ɹ ɛ
nànò	n ɑ n ow
nànòǒ	n ɑ n ow ow
nànó	n ɑ n ow
nànù	n ɑ n ʉ
nànʊ̀	n ɑ n ʊ
nàprì	n ɑ p ɹ i
nàrè	n ɑ ɹ ɛ
nàré	n ɑ ɹ ɛ
nàrɛmnà	n ɑ ɹ ɛ m n ɑ
nàtùɟáj	n ɑ t ʉ dʒ ɑ j
nàt̪ùɟáì	n ɑ t ʉ dʒ ɑ i
nàt̪ùɟájɛ̀	n ɑ t ʉ dʒ ɑ j ɛ
nàt̪ùɟájɛ́	n ɑ t ʉ dʒ ɑ j ɛ
nàùɾɛ̀	n ɑ ʉ ɾ ɛ
nàú	n ɑ ʉ
nàúr	n ɑ ʉ ɹ
nàúɾɛ́	n ɑ ʉ ɾ ɛ
nàvlà	n ɑ v l ɑ
nàvlá	n ɑ v l ɑ
nàvə́lɛ̀ðà	n ɑ v ə l ɛ ð ɑ
nàvə́lɛ̀ðɛ̀	n ɑ v ə l ɛ ð ɛ
nàvə́lɛ̂ðɛ̀	n ɑ v ə l ɛ ð ɛ
nàvɟìgɛ̀	n ɑ v dʒ i ɡ ɛ
nàvɟìgɛ́	n ɑ v dʒ i ɡ ɛ
nàvɟɛ́gɛ́	n ɑ v dʒ ɛ ɡ ɛ
nàðàlàgàráì	n ɑ ð ɑ l ɑ ɡ ɑ ɹ ɑ i
nàðàlgàráì	n ɑ ð ɑ l ɡ ɑ ɹ ɑ i
nàŋná	n ɑ ŋ n ɑ
nàŋnò	n ɑ ŋ n ow
nàŋnɔ̀	n ɑ ŋ n ɒ
nàɽàŋgàr	n ɑ ɹ ɑ ŋ ɡ ɑ ɹ
nàɽàŋgár	n ɑ ɹ ɑ ŋ ɡ ɑ ɹ
nàɽìðɔ́	n ɑ ɹ i ð ɒ
nàɾó	n ɑ ɾ ow
nàɾɔ́	n ɑ ɾ ɒ
ná	n ɑ
nácám	n ɑ tʃ ɑ m
nádàm	n ɑ d ɑ m
nádìðí	n ɑ d i ð i
nájínò	n ɑ j i n ow
nájɛ̀	n ɑ j ɛ
nál	n ɑ l
nálí	n ɑ l i
nálír	n ɑ l i ɹ
nálpúɾɔ́	n ɑ l p ʉ ɾ ɒ
nálpʊ́ɾɔ́	n ɑ l p ʊ ɾ ɒ
nálpʊ́ɾɔ̂	n ɑ l p ʊ ɾ ɒ
nált̪òlè	n ɑ l t ow l ɛ
nálə̀ŋó	n ɑ l ə ŋ ow
nálə̀ŋɔ́	n ɑ l ə ŋ ɒ
nálə̀ŋɔ́ŋ	n ɑ l ə ŋ ɒ ŋ
nálə́ŋɔ́	n ɑ l ə ŋ ɒ
nálɛ̀	n ɑ l ɛ
nálɛ́	n ɑ l ɛ
námàl	n ɑ m ɑ l
námál	n ɑ m ɑ l
námálà	n ɑ m ɑ l ɑ
námálá	n ɑ m ɑ l ɑ
námɔ̀ðɛ̀ɛ̀nɔ́nú	n ɑ m ɒ ð ɛ ɛ n ɒ n ʉ
nán	n ɑ n
nánó	n ɑ n ow
nánʊ̀	n ɑ n ʊ
náré	n ɑ ɹ ɛ
nárǐ	n ɑ ɹ i
nárlɛ̀ŋì	n ɑ ɹ l ɛ ŋ i
nárò	n ɑ ɹ ow
nárt̪íŋí	n ɑ ɹ t i ŋ i
nárú	n ɑ ɹ ʉ
nátɛ́	n ɑ t ɛ
nátɛ́r	n ɑ t ɛ ɹ
návlà	n ɑ v l ɑ
návə̀lɛ̀ðó	n ɑ v ə l ɛ ð ow
návə̀lɛ̀ðɔ́	n ɑ v ə l ɛ ð ɒ
návə́lɛ̀ðà	n ɑ v ə l ɛ ð ɑ
náðúɽà	n ɑ ð ʉ ɹ ɑ
náðɜ̀ŋnɔ́	n ɑ ð ɐ ŋ n ɒ
náŋ	n ɑ ŋ
náŋà	n ɑ ŋ ɑ
náŋácì	n ɑ ŋ ɑ tʃ i
náŋìðɛ̀ɲɛ̀cì	n ɑ ŋ i ð ɛ ɲ ɛ tʃ i
náŋîjɛ̌	n ɑ ŋ i j ɛ
náŋîðɛ̀ŋɛ̀cí	n ɑ ŋ i ð ɛ ŋ ɛ tʃ i
náɲá	n ɑ ɲ ɑ
náɾùwè	n ɑ ɾ ʉ w ɛ
nâdrí	n ɑ d ɹ i
nâj	n ɑ j
nâl	n ɑ l
nǎ	n ɑ
nǎj	n ɑ j
ndà	n d ɑ
ndǎ	n d ɑ
ndoàðáðɛ́	n d ow ɑ ð ɑ ð ɛ
ndòbagě	n d ow b ɑ ɡ ɛ
ndòbà	n d ow b ɑ
ndòbàgɛ̀	n d ow b ɑ ɡ ɛ
ndòbǎ	n d ow b ɑ
ndòŋ	n d ow ŋ
ndó	n d ow
ndràð	n d ɹ ɑ ð
ndráðɛ́	n d ɹ ɑ ð ɛ
ndrèɟɛ̀n	n d ɹ ɛ dʒ ɛ n
ndrèɟɛ̌n	n d ɹ ɛ dʒ ɛ n
ndrě	n d ɹ ɛ
ndrí	n d ɹ i
ndrɛ̀ð	n d ɹ ɛ ð
ndŕdɔ́	n d ɹ d ɒ
ndú	n d ʉ
ndúŋ	n d ʉ ŋ
ndɔba	n d ɒ b ɑ
ndɔbeg	n d ɒ b ɛ ɡ
ndɔbɔ̀g	n d ɒ b ɒ ɡ
ndɔ̀bà	n d ɒ b ɑ
ndɔ̀bàgɛ̀	n d ɒ b ɑ ɡ ɛ
ndɔ̀bàgɛ̌	n d ɒ b ɑ ɡ ɛ
ndɔ̀bɔ̀gɛ̀	n d ɒ b ɒ ɡ ɛ
ndɔ̀n	n d ɒ n
ndɔ́n	n d ɒ n
ndɔ́ŋ	n d ɒ ŋ
ndɔ̌n	n d ɒ n
ndɾìǐ	n d ɾ i i
nd̪abogɛ	n d ɑ b ow ɡ ɛ
nd̪àbògɛ̀	n d ɑ b ow ɡ ɛ
nd̪àbɔ̀gɛ̀	n d ɑ b ɒ ɡ ɛ
nd̪obagɛ	n d ow b ɑ ɡ ɛ
nd̪òbà	n d ow b ɑ
nd̪òbàgɛ̀	n d ow b ɑ ɡ ɛ
nd̪òbáŋ	n d ow b ɑ ŋ
nd̪òbǎ	n d ow b ɑ
nd̪ɔbà	n d ɒ b ɑ
nd̪ɔ̀bagɛ̀	n d ɒ b ɑ ɡ ɛ
nd̪ɔ̀bà	n d ɒ b ɑ
nd̪ɔ̀bàgɛ̀	n d ɒ b ɑ ɡ ɛ
nd̪ɔ̀bàgɛ́	n d ɒ b ɑ ɡ ɛ
nd̪ɔ̀bàgɛ̌	n d ɒ b ɑ ɡ ɛ
nd̪ɔ̀bá	n d ɒ b ɑ
nd̪ɔ̀bǎ	n d ɒ b ɑ
nd̪ɔ̀bɔ̀	n d ɒ b ɒ
nd̪ɾì	n d ɾ i
nerɛ́	n ɛ ɹ ɛ
nè	n ɛ
nèclò	n ɛ tʃ l ow
nèvə́lɛ̀ðà	n ɛ v ə l ɛ ð ɑ
né	n ɛ
nê	n ɛ
ně	n ɛ
ngàðə́nɔ̀nà	n ɡ ɑ ð ə n ɒ n ɑ
ngá	n ɡ ɑ
ni	n i
nijɔ̂	n i j ɒ
nì	n i
nìcìlò	n i tʃ i l ow
nìclò	n i tʃ l ow
nìcò	n i tʃ ow
nìcɔ́lɔ̀	n i tʃ ɒ l ɒ
nìcɔ́lɔ̌	n i tʃ ɒ l ɒ
nìcə̀lò	n i tʃ ə l ow
nìcə̀rðù	n i tʃ ə ɹ ð ʉ
nìcə̀rðú	n i tʃ ə ɹ ð ʉ
nìjɔ̀	n i j ɒ
nìjɔ̂	n i j ɒ
nìjɔ̌	n i j ɒ
nìlí	n i l i
nìlɛ́ð	n i l ɛ ð
nìndɔ̀	n i n d ɒ
nìnd̪ɔ̀	n i n d ɒ
nìrí	n i ɹ i
nìrɛ́mnɛ̀t̪à	n i ɹ ɛ m n ɛ t ɑ
nìt̪ìlɔ́	n i t i l ɒ
nìt̪lɔ́	n i t l ɒ
nìt̪ə̀lɔ̀	n i t ə l ɒ
nìt̪ə̀lɔ́	n i t ə l ɒ
nìðìnɔ́ŋù	n i ð i n ɒ ŋ ʉ
nìɲàvə̀lɛ̀ðà	n i ɲ ɑ v ə l ɛ ð ɑ
nìɲàvə̀lɛ̀ðɛ̀	n i ɲ ɑ v ə l ɛ ð ɛ
nìɲávə́lɛ̀ðɛ̀	n i ɲ ɑ v ə l ɛ ð ɛ
ní	n i
nídúɛ̀t̪ɛ̀	n i d ʉ ɛ t ɛ
níjɔ̀	n i j ɒ
nínà	n i n ɑ
nírí	n i ɹ i
nírɛ̀mnɛ̀t̪ɛ̀	n i ɹ ɛ m n ɛ t ɛ
nít̪ìɾɔ́	n i t i ɾ ɒ
nít̪lɔ̀	n i t l ɒ
nít̪lɔ̌	n i t l ɒ
nít̪ɔ́	n i t ɒ
níðú	n i ð ʉ
níŋ	n i ŋ
níŋí	n i ŋ i
níɲárɛ́	n i ɲ ɑ ɹ ɛ
níɾì	n i ɾ i
níɾí	n i ɾ i
nî	n i
nnɔ́	n n ɒ
nò	n ow
nòlò	n ow l ow
nòló	n ow l ow
nòmì	n ow m i
nòn	n ow n
nònè	n ow n ɛ
nònì	n ow n i
nòðɛ̀	n ow ð ɛ
nó	n ow
nónè	n ow n ɛ
nónì	n ow n i
nónó	n ow n ow
nónô	n ow n ow
nôn	n ow n
nŕdɔ́	n ɹ d ɒ
nùjɛ̀l	n ʉ j ɛ l
nùjɛ́l	n ʉ j ɛ l
nùjɛ́lɛ̀	n ʉ j ɛ l ɛ
nùjɛ́lɛ́	n ʉ j ɛ l ɛ
nùn	n ʉ n
nùnì	n ʉ n i
nùr	n ʉ ɹ
nùðɛ̀	n ʉ ð ɛ
nùðɛ́	n ʉ ð ɛ
nú	n ʉ
núgûɽì	n ʉ ɡ ʉ ɹ i
nújə́lɛ́	n ʉ j ə l ɛ
nújɛ́lɛ̀	n ʉ j ɛ l ɛ
núltúmtánì	n ʉ l t ʉ m t ɑ n i
núnɛ́	n ʉ n ɛ
núr	n ʉ ɹ
núŋú	n ʉ ŋ ʉ
núɽì	n ʉ ɹ i
nûl	n ʉ l
nûltùmtánì	n ʉ l t ʉ m t ɑ n i
nûltúm	n ʉ l t ʉ m
nǔr	n ʉ ɹ
nðùɽì	n ð ʉ ɹ i
nŋátɛ́	n ŋ ɑ t ɛ
nɔ̀kɛ́n	n ɒ k ɛ n
nɔ̀lá	n ɒ l ɑ
nɔ̀mì	n ɒ m i
nɔ̀mná	n ɒ m n ɑ
nɔ̀mnâ	n ɒ m n ɑ
nɔ̀mnɛ̀ð	n ɒ m n ɛ ð
nɔ̀mnɛ́	n ɒ m n ɛ
nɔ̀n	n ɒ n
nɔ̀nà	n ɒ n ɑ
nɔ̀ná	n ɒ n ɑ
nɔ̀nǎ	n ɒ n ɑ
nɔ̀nɔ̀	n ɒ n ɒ
nɔ̀nɔ́	n ɒ n ɒ
nɔ̀rnɔ́	n ɒ ɹ n ɒ
nɔ̀rɛ́	n ɒ ɹ ɛ
nɔ̀ðɛ̀ŋìnà	n ɒ ð ɛ ŋ i n ɑ
nɔ̀ðɜ̀ŋnánó	n ɒ ð ɐ ŋ n ɑ n ow
nɔ̀ŋnɔ̀	n ɒ ŋ n ɒ
nɔ̀ŋnɔ̌	n ɒ ŋ n ɒ
nɔ̀ɲù	n ɒ ɲ ʉ
nɔ́	n ɒ
nɔ́kèn	n ɒ k ɛ n
nɔ́kɛ̀n	n ɒ k ɛ n
nɔ́kɛ́n	n ɒ k ɛ n
nɔ́kɛ̌n	n ɒ k ɛ n
nɔ́l	n ɒ l
nɔ́luŋú	n ɒ l ʉ ŋ ʉ
nɔ́lúŋú	n ɒ l ʉ ŋ ʉ
nɔ́lŋɔ́	n ɒ l ŋ ɒ
nɔ́ĺŋú	n ɒ l ŋ ʉ
nɔ́m	n ɒ m
nɔ́nà	n ɒ n ɑ
nɔ́ntɔt̪a	n ɒ n t ɒ t ɑ
nɔ́nɔ̀	n ɒ n ɒ
nɔ́nɔ́	n ɒ n ɒ
nɔ́nɛ̀	n ɒ n ɛ
nɔ́ŋ	n ɒ ŋ
nɔ́ŋnɔ̀	n ɒ ŋ n ɒ
nɔ́ŋú	n ɒ ŋ ʉ
nɔ́ŋ́	n ɒ ŋ
nɔ̂l	n ɒ l
nɔ̂lu	n ɒ l ʉ
nɔ̂n	n ɒ n
nɔ̂nà	n ɒ n ɑ
nɔ̌n	n ɒ n
nə̀	n ə
nə̀bɽá	n ə b ɹ ɑ
nə̀cə̀lò	n ə tʃ ə l ow
nə̀nɔ̀nɔ́	n ə n ɒ n ɒ
nə̀pɔ́	n ə p ɒ
nə̀pɔ́l	n ə p ɒ l
nə̀rə́ŋì	n ə ɹ ə ŋ i
nə̀rə́ŋɔ̀	n ə ɹ ə ŋ ɒ
nə̀və̀lɛ̀ðɔ́	n ə v ə l ɛ ð ɒ
nə̀ŋnà	n ə ŋ n ɑ
nə̀ŋná	n ə ŋ n ɑ
nə́rdɔ́	n ə ɹ d ɒ
nə́rt̪á	n ə ɹ t ɑ
nɛ	n ɛ
nɛ̀	n ɛ
nɛ̀bɛ̀	n ɛ b ɛ
nɛ̀gɛ̀ðɔ́l	n ɛ ɡ ɛ ð ɒ l
nɛ̀gɛ̀ðɔ̂ĺ	n ɛ ɡ ɛ ð ɒ l
nɛ̀là	n ɛ l ɑ
nɛ̀làɽà	n ɛ l ɑ ɹ ɑ
nɛ̀lɛ̀	n ɛ l ɛ
nɛ̀mbré	n ɛ m b ɹ ɛ
nɛ̀nì	n ɛ n i
nɛ̀nìɲɔ́	n ɛ n i ɲ ɒ
nɛ̀nɔ́nɔ̀l	n ɛ n ɒ n ɒ l
nɛ̀nɔ́nɛ̀	n ɛ n ɒ n ɛ
nɛ̀vlà	n ɛ v l ɑ
nɛ̀və̀là	n ɛ v ə l ɑ
nɛ̀və́lɛ̀ðà	n ɛ v ə l ɛ ð ɑ
nɛ̀və́lɛ̀ðɛ̀	n ɛ v ə l ɛ ð ɛ
nɛ̀v̀là	n ɛ v l ɑ
nɛ̀ðá	n ɛ ð ɑ
nɛ̀ðɔ̀	n ɛ ð ɒ
nɛ̀ŋíjɛ̌	n ɛ ŋ i j ɛ
nɛ̀ŋná	n ɛ ŋ n ɑ
nɛ̀ŋtóðà	n ɛ ŋ t ow ð ɑ
nɛ̀ŋtóðì	n ɛ ŋ t ow ð i
nɛ̀ɲù	n ɛ ɲ ʉ
nɛ̀ɲú	n ɛ ɲ ʉ
nɛ̀ɽà	n ɛ ɹ ɑ
nɛ́	n ɛ
nɛ́lé	n ɛ l ɛ
nɛ́léɲé	n ɛ l ɛ ɲ ɛ
nɛ́léɲɛ́	n ɛ l ɛ ɲ ɛ
nɛ́lê	n ɛ l ɛ
nɛ́lmàɽðén	n ɛ l m ɑ ɹ ð ɛ n
nɛ́rɛ́	n ɛ ɹ ɛ
nɛ́ðà	n ɛ ð ɑ
nɛ́ðɔ́	n ɛ ð ɒ
nɛ́ŋə̀ná	n ɛ ŋ ə n ɑ
nɛ́ɾá	n ɛ ɾ ɑ
nɛ́ɾâ	n ɛ ɾ ɑ
nɛ́ɾɛ̀	n ɛ ɾ ɛ
nɛ́ɾɛ́	n ɛ ɾ ɛ
nɛ́ɾɛ́gɛ̀	n ɛ ɾ ɛ ɡ ɛ
nɛ̂ɛ́	n ɛ ɛ
nɜ̀ðú	n ɐ ð ʉ
nɜ́rú	n ɐ ɹ ʉ
nɜ́rʊ́	n ɐ ɹ ʊ
nɜ́ɾú	n ɐ ɾ ʉ
nʊ̀mì	n ʊ m i
nʊ̀mí	n ʊ m i
nʊ̀mɔ́	n ʊ m ɒ
nʊ̀mɔ̂	n ʊ m ɒ
nʊ̀nì	n ʊ n i
ǹ	n
ǹdàbàgɛ̀	n d ɑ b ɑ ɡ ɛ
ǹdòbàgè	n d ow b ɑ ɡ ɛ
ǹdòbàgɛ̀	n d ow b ɑ ɡ ɛ
ǹdráðɛ̀	n d ɹ ɑ ð ɛ
ǹdrâð	n d ɹ ɑ ð
ǹdrì	n d ɹ i
ǹdrí	n d ɹ i
ǹdɔ̀bà	n d ɒ b ɑ
ǹdɔ̀bàgɛ̀	n d ɒ b ɑ ɡ ɛ
ǹdɾɛ̀ð	n d ɾ ɛ ð
ǹdɾɛ́ð	n d ɾ ɛ ð
ǹd̪òbà	n d ow b ɑ
ǹd̪òbá	n d ow b ɑ
ǹlə̀və̀r	n l ə v ə ɹ
ǹlə̀və́r	n l ə v ə ɹ
ń	n
ńdòbà	n d ow b ɑ
ńdràló	n d ɹ ɑ l ow
ńd̪ɔ̀bàgɛ̀	n d ɒ b ɑ ɡ ɛ
ńt̪ìmìŋì	n t i m i ŋ i
ńt̪ìmíŋì	n t i m i ŋ i
ò	ow
òlá	ow l ɑ
òlò	ow l ow
òló	ow l ow
òmì	ow m i
òndì	ow n d i
ònì	ow n i
òrà	ow ɹ ɑ
òrátàɽɛ́n	ow ɹ ɑ t ɑ ɹ ɛ n
òrɛ̀	ow ɹ ɛ
òðɛ̀	ow ð ɛ
òðɛ̀ɛ̌	ow ð ɛ ɛ
òɽò	ow ɹ ow
òɽùwɛ́l	ow ɹ ʉ w ɛ l
òɽùwɛ́lɛ	ow ɹ ʉ w ɛ l ɛ
òɽùwɛ́lɛ̀	ow ɹ ʉ w ɛ l ɛ
òɽùwɛ́lɛ́	ow ɹ ʉ w ɛ l ɛ
òɽwɛ́l	ow ɹ w ɛ l
òɾà	ow ɾ ɑ
òɾá	ow ɾ ɑ
óndè	ow n d ɛ
óndi	ow n d i
óndì	ow n d i
ónɛ̀	ow n ɛ
ónɛ́	ow n ɛ
órá	ow ɹ ɑ
órɛ̀	ow ɹ ɛ
órɛ́	ow ɹ ɛ
ówà	ow w ɑ
óŋòr	ow ŋ ow ɹ
óŋǒr	ow ŋ ow ɹ
óɟò	ow dʒ ow
óɾá	ow ɾ ɑ
óɾó	ow ɾ ow
óɾóðɛ́	ow ɾ ow ð ɛ
óɾɛ̀	ow ɾ ɛ
óɾɛ́	ow ɾ ɛ
ǒndè	ow n d ɛ
pápìðì	p ɑ p i ð i
pát̪à	p ɑ t ɑ
pìnɔ́	p i n ɒ
pínɔ́	p i n ɒ
pínɔ̂	p i n ɒ
pò	p ow
púrɔ́	p ʉ ɹ ɒ
pɔ̀	p ɒ
pɔ̀n	p ɒ n
pɔ́	p ɒ
pɔ̂	p ɒ
pɛ̀	p ɛ
r	ɹ
ramnà	ɹ ɑ m n ɑ
rà	ɹ ɑ
ràmàn	ɹ ɑ m ɑ n
ràmàɲà	ɹ ɑ m ɑ ɲ ɑ
ràvə́lɛ̀ðɛ̀	ɹ ɑ v ə l ɛ ð ɛ
rá	ɹ ɑ
rábà	ɹ ɑ b ɑ
rámâɲà	ɹ ɑ m ɑ ɲ ɑ
rámnɛ̀t̪ɛ̀	ɹ ɑ m n ɛ t ɛ
ráò	ɹ ɑ ow
ráó	ɹ ɑ ow
ráǒ	ɹ ɑ ow
rávə̀lɛ̀ðó	ɹ ɑ v ə l ɛ ð ow
rávə̀lɛ̀ðɔ́	ɹ ɑ v ə l ɛ ð ɒ
rávə́lɛ̀ðà	ɹ ɑ v ə l ɛ ð ɑ
ráɽí	ɹ ɑ ɹ i
râj	ɹ ɑ j
râré	ɹ ɑ ɹ ɛ
rǎ	ɹ ɑ
rè	ɹ ɛ
rèclò	ɹ ɛ tʃ l ow
rèdú	ɹ ɛ d ʉ
ré	ɹ ɛ
rìcɔ̀	ɹ i tʃ ɒ
rìcə̀lò	ɹ i tʃ ə l ow
rî	ɹ i
rlànd̪á	ɹ l ɑ n d ɑ
rlánd̪ɔ́	ɹ l ɑ n d ɒ
rlɛɲi	ɹ l ɛ ɲ i
rlɛ̀ŋì	ɹ l ɛ ŋ i
rlɛ̀ɲì	ɹ l ɛ ɲ i
rmàn	ɹ m ɑ n
rmàɲà	ɹ m ɑ ɲ ɑ
rnɔ̀nà	ɹ n ɒ n ɑ
ròlà	ɹ ow l ɑ
ròrlà	ɹ ow ɹ l ɑ
ró	ɹ ow
róðà	ɹ ow ð ɑ
rô	ɹ ow
rr	ɹ ɹ
rrr	ɹ ɹ ɹ
rrɔ́mɔ̀cɔ̀	ɹ ɹ ɒ m ɒ tʃ ɒ
rr̀màn	ɹ ɹ m ɑ n
rr̀mán	ɹ ɹ m ɑ n
rt̪ina	ɹ t i n ɑ
rupa	ɹ ʉ p ɑ
rù	ɹ ʉ
rùŋɔ̀	ɹ ʉ ŋ ɒ
rùŋɔ́	ɹ ʉ ŋ ɒ
rùɽàr	ɹ ʉ ɹ ɑ ɹ
rùɽár	ɹ ʉ ɹ ɑ ɹ
rùɽáɾɛ́	ɹ ʉ ɹ ɑ ɾ ɛ
rùɽì	ɹ ʉ ɹ i
rùɽú	ɹ ʉ ɹ ʉ
rú	ɹ ʉ
rúŋù	ɹ ʉ ŋ ʉ
rúŋú	ɹ ʉ ŋ ʉ
rúŋɔ̀	ɹ ʉ ŋ ɒ
rúɽár	ɹ ʉ ɹ ɑ ɹ
rðɛ́mɛ́	ɹ ð ɛ m ɛ
rð̀ɛ̀	ɹ ð ɛ
rŋɔ̀	ɹ ŋ ɒ
rŋɔ̌	ɹ ŋ ɒ
rɔ̀là	ɹ ɒ l ɑ
rɔ̀lǎ	ɹ ɒ l ɑ
rɔ̀mɔ̀cà	ɹ ɒ m ɒ tʃ ɑ
rɔ̀mɔ̀cɔ̀	ɹ ɒ m ɒ tʃ ɒ
rɔ̀ðɔ̀	ɹ ɒ ð ɒ
rɔ́bà	ɹ ɒ b ɑ
rɔ́mɔ̀	ɹ ɒ m ɒ
rɔ́mɔ̀cà	ɹ ɒ m ɒ tʃ ɑ
rɔ́mɔ̀cɔ̀	ɹ ɒ m ɒ tʃ ɒ
rɔ́mɔ́	ɹ ɒ m ɒ
rɔ́mɔ̂	ɹ ɒ m ɒ
rɔ́ðɔ̂	ɹ ɒ ð ɒ
rɔ́ðɔ̂r	ɹ ɒ ð ɒ ɹ
rɔ́ðɔ̌	ɹ ɒ ð ɒ
rɔ̂bà	ɹ ɒ b ɑ
rɔ̂mɔ̀	ɹ ɒ m ɒ
rɔ̂n	ɹ ɒ n
rə̀bùlìjí	ɹ ə b ʉ l i j i
rə̀bùlìðú	ɹ ə b ʉ l i ð ʉ
rə̀bùlú	ɹ ə b ʉ l ʉ
rə̀clò	ɹ ə tʃ l ow
rə̀cə̀lò	ɹ ə tʃ ə l ow
rə̀màɲà	ɹ ə m ɑ ɲ ɑ
rə̀vɛ́	ɹ ə v ɛ
rə̀ðɔ́	ɹ ə ð ɒ
rə̀ŋàcí	ɹ ə ŋ ɑ tʃ i
rə̀ŋgə̀lá	ɹ ə ŋ ɡ ə l ɑ
rə̀ɽà	ɹ ə ɹ ɑ
rə̀ɽì	ɹ ə ɹ i
rə́ɽì	ɹ ə ɹ i
rə́ɽí	ɹ ə ɹ i
rɛ̀	ɹ ɛ
rɛ̀bùlú	ɹ ɛ b ʉ l ʉ
rɛ̀ma	ɹ ɛ m ɑ
rɛ̀mnɛ̀t̪ɛ̀	ɹ ɛ m n ɛ t ɛ
rɛ́	ɹ ɛ
rɛ́l	ɹ ɛ l
rɛ́mnà	ɹ ɛ m n ɑ
rɛ́táj	ɹ ɛ t ɑ j
rɛ́t̪áj	ɹ ɛ t ɑ j
rɛ́t̪áló	ɹ ɛ t ɑ l ow
rɛ́t̪ɛ́n	ɹ ɛ t ɛ n
rɛ́t̪ɜ́lí	ɹ ɛ t ɐ l i
rɛ́t̪ɜ́lɛ́r	ɹ ɛ t ɐ l ɛ ɹ
rɛ̂	ɹ ɛ
rɽò	ɹ ɹ ow
rʊ̀pá	ɹ ʊ p ɑ
rʊ̀ŋɔ̀	ɹ ʊ ŋ ɒ
rʊ̀ŋɔ̌	ɹ ʊ ŋ ɒ
rʊ́vɛ́	ɹ ʊ v ɛ
r̀cò	ɹ tʃ ow
r̀dú	ɹ d ʉ
r̀lànd̪à	ɹ l ɑ n d ɑ
r̀lànd̪á	ɹ l ɑ n d ɑ
r̀lànd̪ɔ́	ɹ l ɑ n d ɒ
r̀lànd̪ɛ̀	ɹ l ɑ n d ɛ
r̀lò	ɹ l ow
r̀ló	ɹ l ow
r̀lɛ̀ɲì	ɹ l ɛ ɲ i
r̀lɛ̀ɲí	ɹ l ɛ ɲ i
r̀lɛ̀ɲɔ̀	ɹ l ɛ ɲ ɒ
r̀màn	ɹ m ɑ n
r̀mànɲà	ɹ m ɑ n ɲ ɑ
r̀mán	ɹ m ɑ n
r̀pí	ɹ p i
r̀ðɛ̀	ɹ ð ɛ
r̀ŋɔ̀	ɹ ŋ ɒ
r̀ɽà	ɹ ɹ ɑ
r̀ɽì	ɹ ɹ i
r̀ɽò	ɹ ɹ ow
r̀ɽó	ɹ ɹ ow
ŕ	ɹ
ŕlànd̪à	ɹ l ɑ n d ɑ
ŕlànd̪àd̪ɛ̀	ɹ l ɑ n d ɑ d ɛ
ŕlànd̪ɛ̀	ɹ l ɑ n d ɛ
ŕlánd̪ɔ́	ɹ l ɑ n d ɒ
ŕlɔ̀ɲɔ̀	ɹ l ɒ ɲ ɒ
ŕlɛ̀ɲi	ɹ l ɛ ɲ i
ŕlɛ̀ɲì	ɹ l ɛ ɲ i
ŕlɛ̀ɲí	ɹ l ɛ ɲ i
ŕlɛ̀ɲɔ̀	ɹ l ɛ ɲ ɒ
ŕlɛ̂nì	ɹ l ɛ n i
ŕlɛ̂ɲi	ɹ l ɛ ɲ i
ŕlɛ̂ɲì	ɹ l ɛ ɲ i
ŕvɛ̀	ɹ v ɛ
ŕvɛ́	ɹ v ɛ
ŕðɛ̀	ɹ ð ɛ
ŕŋɔ̀	ɹ ŋ ɒ
ŕɽì	ɹ ɹ i
ŕɽìɲàɲɛ̀	ɹ ɹ i ɲ ɑ ɲ ɛ
ŕɽò	ɹ ɹ ow
sàdàn	s ɑ d ɑ n
sàmìɲí	s ɑ m i ɲ i
sàɽíŋgɔ̀	s ɑ ɹ i ŋ ɡ ɒ
sàɽíŋgɔ́	s ɑ ɹ i ŋ ɡ ɒ
sábrà	s ɑ b ɹ ɑ
sábrǎ	s ɑ b ɹ ɑ
sábrìt̪ìnò	s ɑ b ɹ i t i n ow
sábr̀t̪ìnò	s ɑ b ɹ t i n ow
sádàn	s ɑ d ɑ n
sádǎn	s ɑ d ɑ n
sápíð̀ò	s ɑ p i ð ow
sárá	s ɑ ɹ ɑ
sásɛ́	s ɑ s ɛ
sátàn	s ɑ t ɑ n
sátàɽàn	s ɑ t ɑ ɹ ɑ n
sátàɽán	s ɑ t ɑ ɹ ɑ n
sátàɽǎn	s ɑ t ɑ ɹ ɑ n
sátáɽàn	s ɑ t ɑ ɹ ɑ n
sáðúɽà	s ɑ ð ʉ ɹ ɑ
sedɛ̀ŋun	s ɛ d ɛ ŋ ʉ n
sè	s ɛ
sìcə̀lò	s i tʃ ə l ow
síŋg̀	s i ŋ ɡ
soɔ̀ðí́	s ow ɒ ð i
sòɽìt̪ɔ́	s ow ɹ i t ɒ
sùɽù	s ʉ ɹ ʉ
súɽù	s ʉ ɹ ʉ
súɽú	s ʉ ɹ ʉ
sɔ̀ɲá	s ɒ ɲ ɑ
sɔ̀ɽìŋgɔ́	s ɒ ɹ i ŋ ɡ ɒ
sɔ̀ɽíŋgɔ̀	s ɒ ɹ i ŋ ɡ ɒ
sɔ̀ɽíŋgɔ́	s ɒ ɹ i ŋ ɡ ɒ
sɔ́ɽíŋgɔ́	s ɒ ɹ i ŋ ɡ ɒ
sə́tàn	s ə t ɑ n
sɛ	s ɛ
sɛ̀	s ɛ
sɛ́	s ɛ
sɛ̂ɛ́	s ɛ ɛ
sɾɛ	s ɾ ɛ
śðə̀làŋà	s ð ə l ɑ ŋ ɑ
tà	t ɑ
tàmə̀ɾðɔ́	t ɑ m ə ɾ ð ɒ
tàsà	t ɑ s ɑ
tá	t ɑ
támə̀rðɛ̀	t ɑ m ə ɹ ð ɛ
tánì	t ɑ n i
tásà	t ɑ s ɑ
tásá	t ɑ s ɑ
tásǎ	t ɑ s ɑ
táɾó	t ɑ ɾ ow
tìjó	t i j ow
tòlèɲà	t ow l ɛ ɲ ɑ
tòlèɲá	t ow l ɛ ɲ ɑ
tòlèɲâ	t ow l ɛ ɲ ɑ
tòlìɲà	t ow l i ɲ ɑ
tòsà	t ow s ɑ
tòsò	t ow s ow
tòðà	t ow ð ɑ
tòðá	t ow ð ɑ
tòðó	t ow ð ow
tólí	t ow l i
tóðà	t ow ð ɑ
tóðó	t ow ð ow
tô	t ow
tùtɔ̀	t ʉ t ɒ
tùtɔ́	t ʉ t ɒ
tùɛ́l	t ʉ ɛ l
túm	t ʉ m
túmt̪ánì	t ʉ m t ɑ n i
tútɔ̀	t ʉ t ɒ
tútɔ́	t ʉ t ɒ
tút̪ú	t ʉ t ʉ
tɔ̀r	t ɒ ɹ
tɔ́rr	t ɒ ɹ ɹ
tɔ́wə̀nì	t ɒ w ə n i
tə̀màn	t ə m ɑ n
tə̀vá	t ə v ɑ
tə̀ɽà	t ə ɹ ɑ
tə́màn	t ə m ɑ n
tə́và	t ə v ɑ
tə́vɔ́	t ə v ɒ
tɛ̀nɔ̀nɔ́	t ɛ n ɒ n ɒ
tɛ́	t ɛ
tɜ́wɜ̀nì	t ɐ w ɐ n i
tɾâw̌	t ɾ ɑ w
tʊ̀lí	t ʊ l i
tʊ́	t ʊ
tʊ́lìɲá	t ʊ l i ɲ ɑ
tʊ́lí	t ʊ l i
t̪al	t ɑ l
t̪aŋ	t ɑ ŋ
t̪à	t ɑ
t̪àmɔ̀rðɔ́	t ɑ m ɒ ɹ ð ɒ
t̪àməɾðɔ́	t ɑ m ə ɾ ð ɒ
t̪àmə̀rðɔ́	t ɑ m ə ɹ ð ɒ
t̪àmə̀ɾðɔ́	t ɑ m ə ɾ ð ɒ
t̪ànd̪àrù	t ɑ n d ɑ ɹ ʉ
t̪àrlɛ̀ɲì	t ɑ ɹ l ɛ ɲ i
t̪àrlɛ̂ɲì	t ɑ ɹ l ɛ ɲ i
t̪àrɔ́t̪ɛ́	t ɑ ɹ ɒ t ɛ
t̪àrɔ́ŋt̪ɛ́	t ɑ ɹ ɒ ŋ t ɛ
t̪àŕlɛ̂ɲì	t ɑ ɹ l ɛ ɲ i
t̪àt̪ɔ́	t ɑ t ɒ
t̪àúɽìt̪ɛ̀	t ɑ ʉ ɹ i t ɛ
t̪àúɽìðì	t ɑ ʉ ɹ i ð i
t̪àvə́lɛ̂ðɛ̀	t ɑ v ə l ɛ ð ɛ
t̪àwànì	t ɑ w ɑ n i
t̪àwɔ̀nì	t ɑ w ɒ n i
t̪àwə̀nì	t ɑ w ə n i
t̪àððàt̪ɔ́	t ɑ ð ð ɑ t ɒ
t̪àððɔ́	t ɑ ð ð ɒ
t̪àðɔ́	t ɑ ð ɒ
t̪àðə́və̀lɛ̀ðà	t ɑ ð ə v ə l ɛ ð ɑ
t̪àðə́və̀lɛ̀ðɔ́	t ɑ ð ə v ə l ɛ ð ɒ
t̪àŋòŋ	t ɑ ŋ ow ŋ
t̪àŋòŋs	t ɑ ŋ ow ŋ s
t̪àŋó	t ɑ ŋ ow
t̪àŋvə́lɛ̂ðɛ̀	t ɑ ŋ v ə l ɛ ð ɛ
t̪àɾó	t ɑ ɾ ow
t̪àɾt̪ɔ́	t ɑ ɾ t ɒ
t̪á	t ɑ
t̪ábùðú	t ɑ b ʉ ð ʉ
t̪ábúðà	t ɑ b ʉ ð ɑ
t̪áì	t ɑ i
t̪ál	t ɑ l
t̪álè	t ɑ l ɛ
t̪álì	t ɑ l i
t̪álvə̀lɛ̀ðɔ́	t ɑ l v ə l ɛ ð ɒ
t̪ámɔ́rðà	t ɑ m ɒ ɹ ð ɑ
t̪ámə̀ɾðà	t ɑ m ə ɾ ð ɑ
t̪ámə́rðààpríɲâ	t ɑ m ə ɹ ð ɑ ɑ p ɹ i ɲ ɑ
t̪áníní	t ɑ n i n i
t̪ánɔ́nà	t ɑ n ɒ n ɑ
t̪át̪ɛ́	t ɑ t ɛ
t̪ávə̀lɛ̀ðɔ́	t ɑ v ə l ɛ ð ɒ
t̪ávə́lɛ̀ðà	t ɑ v ə l ɛ ð ɑ
t̪áwə̀nì	t ɑ w ə n i
t̪áwə́nî	t ɑ w ə n i
t̪áŋ	t ɑ ŋ
t̪áŋíjɔ̀	t ɑ ŋ i j ɒ
t̪áŋíjɔ́	t ɑ ŋ i j ɒ
t̪áŋnɔ̀nɔ̀	t ɑ ŋ n ɒ n ɒ
t̪áŋvə́lɛ̀ðɔ́	t ɑ ŋ v ə l ɛ ð ɒ
t̪áɽáná	t ɑ ɹ ɑ n ɑ
t̪áɾó	t ɑ ɾ ow
t̪áɾɔ́t̪ɛ́	t ɑ ɾ ɒ t ɛ
t̪âlvə̀lɛ̀ðɛ̀	t ɑ l v ə l ɛ ð ɛ
t̪âlvə̀lɛ̀ðɛ́	t ɑ l v ə l ɛ ð ɛ
t̪ǎ	t ɑ
t̪icilʊ	t i tʃ i l ʊ
t̪ìcò	t i tʃ ow
t̪ìcəlò	t i tʃ ə l ow
t̪ìcə̀ló	t i tʃ ə l ow
t̪ìjàt̪ɔ́	t i j ɑ t ɒ
t̪ìjá	t i j ɑ
t̪ìjɔ́	t i j ɒ
t̪ìmíŋì	t i m i ŋ i
t̪ìmíŋí	t i m i ŋ i
t̪ìrci	t i ɹ tʃ i
t̪ìrlɛ̀ɲí	t i ɹ l ɛ ɲ i
t̪ìðìnt̪ɔ́	t i ð i n t ɒ
t̪ìðìɲàcì	t i ð i ɲ ɑ tʃ i
t̪ìðìɲîŋì	t i ð i ɲ i ŋ i
t̪íjí	t i j i
t̪oleɲa	t ow l ɛ ɲ ɑ
t̪olèɲ	t ow l ɛ ɲ
t̪owəni	t ow w ə n i
t̪òlà	t ow l ɑ
t̪òlè	t ow l ɛ
t̪òlèɲ	t ow l ɛ ɲ
t̪òlèɲa	t ow l ɛ ɲ ɑ
t̪òlèɲaánó	t ow l ɛ ɲ ɑ ɑ n ow
t̪òlèɲà	t ow l ɛ ɲ ɑ
t̪òlèɲá	t ow l ɛ ɲ ɑ
t̪òlèɲánò	t ow l ɛ ɲ ɑ n ow
t̪òlèɲánó	t ow l ɛ ɲ ɑ n ow
t̪òlèɲánù	t ow l ɛ ɲ ɑ n ʉ
t̪òlèɲánú	t ow l ɛ ɲ ɑ n ʉ
t̪òlèɲánû	t ow l ɛ ɲ ɑ n ʉ
t̪òlèɲâ	t ow l ɛ ɲ ɑ
t̪òlèɲ́	t ow l ɛ ɲ
t̪òlé	t ow l ɛ
t̪òléŋ	t ow l ɛ ŋ
t̪òlì	t ow l i
t̪òlìɲà	t ow l i ɲ ɑ
t̪òlìɲá	t ow l i ɲ ɑ
t̪òlìɲánô	t ow l i ɲ ɑ n ow
t̪òlìɲánù	t ow l i ɲ ɑ n ʉ
t̪òlìɲâ	t ow l i ɲ ɑ
t̪òlìɲ́	t ow l i ɲ
t̪òlì̂	t ow l i
t̪òlí	t ow l i
t̪òlî	t ow l i
t̪òl̀ɲ́	t ow l ɲ
t̪òrlà	t ow ɹ l ɑ
t̪òɽìɲ	t ow ɹ i ɲ
t̪ó	t ow
t̪ólè	t ow l ɛ
t̪ólèɲ	t ow l ɛ ɲ
t̪ólèɲà	t ow l ɛ ɲ ɑ
t̪ólèɲá	t ow l ɛ ɲ ɑ
t̪ólèɲánó	t ow l ɛ ɲ ɑ n ow
t̪ólèɲánú	t ow l ɛ ɲ ɑ n ʉ
t̪ólèɲâ	t ow l ɛ ɲ ɑ
t̪ólèɲâá	t ow l ɛ ɲ ɑ ɑ
t̪ólèɲǎ	t ow l ɛ ɲ ɑ
t̪ólèɲ́	t ow l ɛ ɲ
t̪ólé	t ow l ɛ
t̪ólén	t ow l ɛ n
t̪óléɲà	t ow l ɛ ɲ ɑ
t̪óléɲá	t ow l ɛ ɲ ɑ
t̪óléɲâ	t ow l ɛ ɲ ɑ
t̪ólì	t ow l i
t̪ólìɲà	t ow l i ɲ ɑ
t̪ólìɲǎ	t ow l i ɲ ɑ
t̪ólí	t ow l i
t̪ólǐ	t ow l i
t̪óndì	t ow n d i
t̪ówà	t ow w ɑ
t̪ówànì	t ow w ɑ n i
t̪ówàní	t ow w ɑ n i
t̪ówànî	t ow w ɑ n i
t̪ówànî́	t ow w ɑ n i
t̪ówə̀nì	t ow w ə n i
t̪ô	t ow
t̪rɛ́	t ɹ ɛ
t̪ùálé	t ʉ ɑ l ɛ
t̪ùlè	t ʉ l ɛ
t̪ùlì	t ʉ l i
t̪ùlí	t ʉ l i
t̪úlè	t ʉ l ɛ
t̪úlì	t ʉ l i
t̪úlí	t ʉ l i
t̪út̪ù	t ʉ t ʉ
t̪út̪ú	t ʉ t ʉ
t̪ɔ̀là	t ɒ l ɑ
t̪ɔ̀lèɲáŋ	t ɒ l ɛ ɲ ɑ ŋ
t̪ɔ̀lèɲâáŋ	t ɒ l ɛ ɲ ɑ ɑ ŋ
t̪ɔ̀léŋ	t ɒ l ɛ ŋ
t̪ɔ̀lêŋ́	t ɒ l ɛ ŋ
t̪ɔ̀t̪á	t ɒ t ɑ
t̪ɔ̀wànì	t ɒ w ɑ n i
t̪ɔ̀wə̀nì	t ɒ w ə n i
t̪ɔ̀wə̀ní	t ɒ w ə n i
t̪ɔ̀wɜ̀nì	t ɒ w ɐ n i
t̪ɔ̀ɽá	t ɒ ɹ ɑ
t̪ɔ́	t ɒ
t̪ɔ́nɔ́nà	t ɒ n ɒ n ɑ
t̪ɔ́t̪ɔ̀	t ɒ t ɒ
t̪ɔ́t̪ɔ́	t ɒ t ɒ
t̪ɔ́wànì	t ɒ w ɑ n i
t̪ɔ́wànî	t ɒ w ɑ n i
t̪ɔ́wə̀nì	t ɒ w ə n i
t̪ɔ́wə̀nìdìbɔ́ðɔ̀	t ɒ w ə n i d i b ɒ ð ɒ
t̪ɔ́wə̀nìnùb	t ɒ w ə n i n ʉ b
t̪ɔ́wə̀ní	t ɒ w ə n i
t̪ɔ́wə̀ǹ	t ɒ w ə n
t̪ɔ́wə́nì	t ɒ w ə n i
t̪ɔ́ɽà	t ɒ ɹ ɑ
t̪ɔ́ɽɔ́	t ɒ ɹ ɒ
t̪ɔ̌	t ɒ
t̪əɽiɲɔ́ɔ́ɟɔ́	t ə ɹ i ɲ ɒ ɒ dʒ ɒ
t̪ə̀lèɲ	t ə l ɛ ɲ
t̪ə̀màn	t ə m ɑ n
t̪ə̀mǎn	t ə m ɑ n
t̪ə̀mmànt̪à	t ə m m ɑ n t ɑ
t̪ə̀nɔ̀nɔ́	t ə n ɒ n ɒ
t̪ə̀rá	t ə ɹ ɑ
t̪ə̀rǎ	t ə ɹ ɑ
t̪ə̀rlɛ̀ɲí	t ə ɹ l ɛ ɲ i
t̪ə̀và	t ə v ɑ
t̪ə̀vá	t ə v ɑ
t̪ə̀vé	t ə v ɛ
t̪ə̀vɔ́	t ə v ɒ
t̪ə̀və̀lèðɔ́	t ə v ə l ɛ ð ɒ
t̪ə̀və̀lɛ̀ðɔ̀ŋ	t ə v ə l ɛ ð ɒ ŋ
t̪ə̀və̀lɛ̀ðɔ́	t ə v ə l ɛ ð ɒ
t̪ə̀və̀lɛ̀ðɔ́ŋ	t ə v ə l ɛ ð ɒ ŋ
t̪ə̀wànì	t ə w ɑ n i
t̪ə̀wə̀nì	t ə w ə n i
t̪ə̀ɽà	t ə ɹ ɑ
t̪ə̀ɽá	t ə ɹ ɑ
t̪ə̀ɽìɲɔ́	t ə ɹ i ɲ ɒ
t̪ə̀ɽìɲɔ́ɔ́ɟɔ́	t ə ɹ i ɲ ɒ ɒ dʒ ɒ
t̪ə̀ɾɛ̀	t ə ɾ ɛ
t̪ə́màn	t ə m ɑ n
t̪ə́mànt̪ǎ	t ə m ɑ n t ɑ
t̪ə́mánt̪à	t ə m ɑ n t ɑ
t̪ə́mánt̪á	t ə m ɑ n t ɑ
t̪ə́mmànt̪à	t ə m m ɑ n t ɑ
t̪ə́rlɛ̀ní	t ə ɹ l ɛ n i
t̪ə́rlɛ̀ɲí	t ə ɹ l ɛ ɲ i
t̪ə́rvàvì	t ə ɹ v ɑ v i
t̪ə́rvàvɛ̀	t ə ɹ v ɑ v ɛ
t̪ə́và	t ə v ɑ
t̪ə́vɔ́	t ə v ɒ
t̪ə́vɔ̂	t ə v ɒ
t̪ə́vɛ̀	t ə v ɛ
t̪ə́wə̀nì	t ə w ə n i
t̪ə́ɽá	t ə ɹ ɑ
t̪ɛ̀	t ɛ
t̪ɛ̀mí	t ɛ m i
t̪ɛ̀míŋ	t ɛ m i ŋ
t̪ɛ̀nɔ̀nìnɔ̀	t ɛ n ɒ n i n ɒ
t̪ɛ̀nɔ̀níŋí	t ɛ n ɒ n i ŋ i
t̪ɛ̀nɔ̀nɔ̀	t ɛ n ɒ n ɒ
t̪ɛ̀nɔ̀nɔ́	t ɛ n ɒ n ɒ
t̪ɛ̀nɔ̀nɔ́ŋ	t ɛ n ɒ n ɒ ŋ
t̪ɛ̀nɔ̀nɔ́ŋú	t ɛ n ɒ n ɒ ŋ ʉ
t̪ɛ̀rlɛ̀ɲí	t ɛ ɹ l ɛ ɲ i
t̪ɛ́	t ɛ
t̪ɛ́míŋ	t ɛ m i ŋ
t̪ɛ́nɔ̀nɔ́	t ɛ n ɒ n ɒ
t̪ɛ̂ɛ́	t ɛ ɛ
t̪ɜ̀wɜ̀nì	t ɐ w ɐ n i
t̪ɜ́wə̀nì	t ɐ w ə n i
t̪ɾə́	t ɾ ə
t̪ʊ̀lì	t ʊ l i
t̪ʊ̀lí	t ʊ l i
t̪ʊ̀lə́	t ʊ l ə
t̪ʊ́	t ʊ
t̪ʊ́lì	t ʊ l i
t̪ʊ́lí	t ʊ l i
t̪ʊ́líɲâ	t ʊ l i ɲ ɑ
t̪̀	t
undɔbajɛ	ʉ n d ɒ b ɑ j ɛ
undɔ̀bàgɛ̀	ʉ n d ɒ b ɑ ɡ ɛ
unɛɾɛ	ʉ n ɛ ɾ ɛ
unɛɾɛɛ̀	ʉ n ɛ ɾ ɛ ɛ
unɛ̀rɛ̀	ʉ n ɛ ɹ ɛ
unɛ̀ɾɛ̀	ʉ n ɛ ɾ ɛ
urnɔ	ʉ ɹ n ɒ
ur̀nɔ̀	ʉ ɹ n ɒ
uɟi	ʉ dʒ i
uɽi	ʉ ɹ i
ùbí	ʉ b i
ùcùl	ʉ tʃ ʉ l
ùdí	ʉ d i
ùdúlə́ŋàɲà	ʉ d ʉ l ə ŋ ɑ ɲ ɑ
ùdɔ́	ʉ d ɒ
ùd̪ɔ̀	ʉ d ɒ
ùd̪ɔ́	ʉ d ɒ
ùd̪ɔ̂	ʉ d ɒ
ùd̪ɛ̀	ʉ d ɛ
ùjɛ̀l	ʉ j ɛ l
ùjɛ́lɛ̀	ʉ j ɛ l ɛ
ùlíŋgè	ʉ l i ŋ ɡ ɛ
ùlíŋgé	ʉ l i ŋ ɡ ɛ
ùlíŋgɛ̀	ʉ l i ŋ ɡ ɛ
ùlíŋgɛ́	ʉ l i ŋ ɡ ɛ
ùlùŋù	ʉ l ʉ ŋ ʉ
ùlùŋú	ʉ l ʉ ŋ ʉ
ùlùŋǔ	ʉ l ʉ ŋ ʉ
ùlɔ̀	ʉ l ɒ
ùlɔ́	ʉ l ɒ
ùmè	ʉ m ɛ
ùmì	ʉ m i
ùmí	ʉ m i
ùmɔ̀ðɔ́	ʉ m ɒ ð ɒ
ùnàlú	ʉ n ɑ l ʉ
ùnèɛ̀rɛ̀	ʉ n ɛ ɛ ɹ ɛ
ùnì	ʉ n i
ùnɔ̀	ʉ n ɒ
ùnɛ̀lí	ʉ n ɛ l i
ùnɛ̀lír	ʉ n ɛ l i ɹ
ùnɛ̀rè	ʉ n ɛ ɹ ɛ
ùnɛ̀ré	ʉ n ɛ ɹ ɛ
ùnɛ̀rɛ	ʉ n ɛ ɹ ɛ
ùnɛ̀rɛ̀	ʉ n ɛ ɹ ɛ
ùnɛ̀rɛ̌	ʉ n ɛ ɹ ɛ
ùnɛ̀ɾɛ	ʉ n ɛ ɾ ɛ
ùnɛ̀ɾɛ̀	ʉ n ɛ ɾ ɛ
ùnɛ̀ɾɛ́	ʉ n ɛ ɾ ɛ
ùnɛ̀ɾɛ̂	ʉ n ɛ ɾ ɛ
ùnɛ̀ɾɛ̌	ʉ n ɛ ɾ ɛ
ùnɛ́	ʉ n ɛ
ùnɛ́j	ʉ n ɛ j
ùnɛ́n	ʉ n ɛ n
ùnɛ́rè	ʉ n ɛ ɹ ɛ
ùnɛ́rɛ̀	ʉ n ɛ ɹ ɛ
ùnɛ́rɛ́	ʉ n ɛ ɹ ɛ
ùnɛ́rɛ̂	ʉ n ɛ ɹ ɛ
ùnɛ́ɾɛ̀	ʉ n ɛ ɾ ɛ
ùnɛ́ɾɛ̀̀	ʉ n ɛ ɾ ɛ
ùnɛ́ɾɛ̀̌	ʉ n ɛ ɾ ɛ
ùnɛ́ɾɛ́	ʉ n ɛ ɾ ɛ
ùnɛ́ɾɛ̂	ʉ n ɛ ɾ ɛ
ùnɛ́ɾɛ̌	ʉ n ɛ ɾ ɛ
ùrmùðɔ́	ʉ ɹ m ʉ ð ɒ
ùrmə̀ðɔ́	ʉ ɹ m ə ð ɒ
ùrnàŋgèí	ʉ ɹ n ɑ ŋ ɡ ɛ i
ùrnàŋgéi	ʉ ɹ n ɑ ŋ ɡ ɛ i
ùrnò	ʉ ɹ n ow
ùrnɔ	ʉ ɹ n ɒ
ùrnɔ̀	ʉ ɹ n ɒ
ùrnɔ́	ʉ ɹ n ɒ
ùrnɔ̌	ʉ ɹ n ɒ
ùrǹɔ̀	ʉ ɹ n ɒ
ùrù	ʉ ɹ ʉ
ùrǔ	ʉ ɹ ʉ
ùrɔ̀	ʉ ɹ ɒ
ùrɔ̀t̪ɔ́	ʉ ɹ ɒ t ɒ
ùrɔ́	ʉ ɹ ɒ
ùt̪ùlá	ʉ t ʉ l ɑ
ùt̪ùlú	ʉ t ʉ l ʉ
ùðò	ʉ ð ow
ùðɔ́	ʉ ð ɒ
ùðɛ̀	ʉ ð ɛ
ùðɛ́	ʉ ð ɛ
ùɟì	ʉ dʒ i
ùɟí	ʉ dʒ i
ùɽcá	ʉ ɹ tʃ ɑ
ùɽì	ʉ ɹ i
ùɽìt̪á	ʉ ɹ i t ɑ
ùɽìðàt̪á	ʉ ɹ i ð ɑ t ɑ
ùɽìðá	ʉ ɹ i ð ɑ
ùɽìðù	ʉ ɹ i ð ʉ
ùɽìðú	ʉ ɹ i ð ʉ
ùɽìɟɛ̀n	ʉ ɹ i dʒ ɛ n
ùɽí	ʉ ɹ i
ùɽò	ʉ ɹ ow
ùɽó	ʉ ɹ ow
ùɽùwò	ʉ ɹ ʉ w ow
ùɽùwɔ̀	ʉ ɹ ʉ w ɒ
ùɽùwʊ̀	ʉ ɹ ʉ w ʊ
ùɽðìðɔ́	ʉ ɹ ð i ð ɒ
ùɽɔ̀	ʉ ɹ ɒ
ùɽɔ́	ʉ ɹ ɒ
ùɽɟɛ̀n	ʉ ɹ dʒ ɛ n
ùɽɟɛ́nɛ́	ʉ ɹ dʒ ɛ n ɛ
ùɾnɔ̀	ʉ ɾ n ɒ
ùɾnɔ̀ɔ̌	ʉ ɾ n ɒ ɒ
ùɾnɔ́	ʉ ɾ n ɒ
ùɾnɔ̌	ʉ ɾ n ɒ
ùɾɔ̀	ʉ ɾ ɒ
ú	ʉ
úcùlɔ̀	ʉ tʃ ʉ l ɒ
údí	ʉ d i
údɔ̀	ʉ d ɒ
údɔ́	ʉ d ɒ
údɛ̀	ʉ d ɛ
úd̪ɔ̀	ʉ d ɒ
úd̪ɔ́	ʉ d ɒ
úd̪ɛ̀	ʉ d ɛ
újə́lɛ́	ʉ j ə l ɛ
újɛ́lɛ̀	ʉ j ɛ l ɛ
újɛ̌l	ʉ j ɛ l
úkùŋá	ʉ k ʉ ŋ ɑ
úkùŋú	ʉ k ʉ ŋ ʉ
úkùŋ́	ʉ k ʉ ŋ
úkú	ʉ k ʉ
úlíŋgɛ̀	ʉ l i ŋ ɡ ɛ
úlùŋù	ʉ l ʉ ŋ ʉ
úlɔ̀	ʉ l ɒ
úmí	ʉ m i
úmùðù	ʉ m ʉ ð ʉ
úmɔ́ðɔ́	ʉ m ɒ ð ɒ
úmə̀ðɛ̀ðɛ̀	ʉ m ə ð ɛ ð ɛ
úmɛ̀	ʉ m ɛ
ún	ʉ n
únì	ʉ n i
únɛ̀rɛ̀	ʉ n ɛ ɹ ɛ
únɛ̀rɛ́	ʉ n ɛ ɹ ɛ
únɛ̀ɾɛ̀	ʉ n ɛ ɾ ɛ
únɛ̀ɾɛ́	ʉ n ɛ ɾ ɛ
únɛ̀ɾɛ̂	ʉ n ɛ ɾ ɛ
únɛ̀ɾɛ̌	ʉ n ɛ ɾ ɛ
únɛ́rɛ̀	ʉ n ɛ ɹ ɛ
únɛ́rɛ́	ʉ n ɛ ɹ ɛ
únɛ́rɛ̂	ʉ n ɛ ɹ ɛ
únɛ́rɛ̌	ʉ n ɛ ɹ ɛ
únɛ́ɾɛ̀	ʉ n ɛ ɾ ɛ
únɛ́ɾɛ́	ʉ n ɛ ɾ ɛ
únɛ́ɾɛ̂	ʉ n ɛ ɾ ɛ
únɛ́̀rɛ̀	ʉ n ɛ ɹ ɛ
úr	ʉ ɹ
úrmúðɔ́	ʉ ɹ m ʉ ð ɒ
úrmə̀ðɔ̀	ʉ ɹ m ə ð ɒ
úrmə̀ðɛ̀ðɛ̀	ʉ ɹ m ə ð ɛ ð ɛ
úrmə́ðɔ́	ʉ ɹ m ə ð ɒ
úrmʊ́ðɔ̂	ʉ ɹ m ʊ ð ɒ
úrmʊ́ðɔ̂ɔ́	ʉ ɹ m ʊ ð ɒ ɒ
úrnàŋgěí	ʉ ɹ n ɑ ŋ ɡ ɛ i
úrnò	ʉ ɹ n ow
úrnǒ	ʉ ɹ n ow
úrnɔ̀	ʉ ɹ n ɒ
úrnɔ́	ʉ ɹ n ɒ
úrnɔ̌	ʉ ɹ n ɒ
úrú	ʉ ɹ ʉ
úrɔ̀	ʉ ɹ ɒ
úrɔ̀t̪ɔ̀t̪ɛ̀	ʉ ɹ ɒ t ɒ t ɛ
úrɔ̀t̪ɛ̀t̪ɛ̀	ʉ ɹ ɒ t ɛ t ɛ
úrɔ́t̪ɔ́	ʉ ɹ ɒ t ɒ
út̪ìðí	ʉ t i ð i
út̪û	ʉ t ʉ
úwɔ̀	ʉ w ɒ
úwɔ́	ʉ w ɒ
úðó	ʉ ð ow
úðô	ʉ ð ow
úðɔ̀	ʉ ð ɒ
úðɔ́	ʉ ð ɒ
úðɔ̂	ʉ ð ɒ
úðɛ̀	ʉ ð ɛ
úðɛ́	ʉ ð ɛ
úŋ	ʉ ŋ
úŋátɛ́və́lɛ̂ðɛ̀	ʉ ŋ ɑ t ɛ v ə l ɛ ð ɛ
úɟí	ʉ dʒ i
úɟɛ̌	ʉ dʒ ɛ
úɽcá	ʉ ɹ tʃ ɑ
úɽcí	ʉ ɹ tʃ i
úɽì	ʉ ɹ i
úɽìðà	ʉ ɹ i ð ɑ
úɽìðì	ʉ ɹ i ð i
úɽít̪ɔ́	ʉ ɹ i t ɒ
úɽíðát̪ɔ́	ʉ ɹ i ð ɑ t ɒ
úɽíðíðí	ʉ ɹ i ð i ð i
úɽíðó	ʉ ɹ i ð ow
úɽíðû	ʉ ɹ i ð ʉ
úɽǐ	ʉ ɹ i
úɽó	ʉ ɹ ow
úɽùwɔ̀	ʉ ɹ ʉ w ɒ
úɽúvɔ́	ʉ ɹ ʉ v ɒ
úɽɟí	ʉ ɹ dʒ i
úɽɟɛ́nɛ̀	ʉ ɹ dʒ ɛ n ɛ
úɾnɔ̌	ʉ ɾ n ɒ
ûnɛ̀rɛ̀	ʉ n ɛ ɹ ɛ
ûrmə̀ðɔ́	ʉ ɹ m ə ð ɒ
ûrnɔ̀	ʉ ɹ n ɒ
ûɾnɔ̀	ʉ ɾ n ɒ
và	v ɑ
vàràt̪á	v ɑ ɹ ɑ t ɑ
vàrt̪ɔ́	v ɑ ɹ t ɒ
vàɽàcɔ́	v ɑ ɹ ɑ tʃ ɒ
vàɽàn	v ɑ ɹ ɑ n
vàɾá	v ɑ ɾ ɑ
vàɾú	v ɑ ɾ ʉ
várà	v ɑ ɹ ɑ
várát̪ó	v ɑ ɹ ɑ t ow
várát̪ɔ́	v ɑ ɹ ɑ t ɒ
várì	v ɑ ɹ i
váró	v ɑ ɹ ow
váɽàn	v ɑ ɹ ɑ n
váɽácí	v ɑ ɹ ɑ tʃ i
váɾà	v ɑ ɾ ɑ
váɾó	v ɑ ɾ ow
vé	v ɛ
vlɛ̀ðɔ́	v l ɛ ð ɒ
vlɛ̂ðɔ́	v l ɛ ð ɒ
vr	v ɹ
vràðá	v ɹ ɑ ð ɑ
vráðɔ́	v ɹ ɑ ð ɒ
vr̀ðàt̪ɔ́	v ɹ ð ɑ t ɒ
vr̀ðìjí	v ɹ ð i j i
vr̀ðìnɔ́	v ɹ ð i n ɒ
vr̀ðìt̪ɔ́	v ɹ ð i t ɒ
vr̀ðìðú	v ɹ ð i ð ʉ
vr̀ðɔ̀	v ɹ ð ɒ
vr̀ðɔ̀t̪ɔ́	v ɹ ð ɒ t ɒ
vr̀ðɔ̀ðìt̪ɔ́	v ɹ ð ɒ ð i t ɒ
vr̀ðɔ̀ðɔ́	v ɹ ð ɒ ð ɒ
vr̀ðɔ́	v ɹ ð ɒ
vr̀ðə̀t̪ɔ̀t̪ɔ́	v ɹ ð ə t ɒ t ɒ
vr̀ðɜ̀ìnɔ́	v ɹ ð ɐ i n ɒ
vŕ	v ɹ
vŕr	v ɹ ɹ
vŕðát̪ɔ́	v ɹ ð ɑ t ɒ
vŕðìjɔ̀	v ɹ ð i j ɒ
vŕðìnɔ̀	v ɹ ð i n ɒ
vŕðìt̪ɔ̀	v ɹ ð i t ɒ
vŕðɔ̀	v ɹ ð ɒ
vŕðɔ̀t̪ɔ̀	v ɹ ð ɒ t ɒ
vŕðɔ̀ðìt̪ɔ̀	v ɹ ð ɒ ð i t ɒ
vŕðɔ̀ðɔ̀	v ɹ ð ɒ ð ɒ
vŕðɔ́	v ɹ ð ɒ
vŕðə̀t̪ɔ̀t̪ɔ̀	v ɹ ð ə t ɒ t ɒ
vŕðɛ̀	v ɹ ð ɛ
vŕðɜ̀ìnɔ̀	v ɹ ð ɐ i n ɒ
vɔ̀ɽàcɔ́	v ɒ ɹ ɑ tʃ ɒ
vɔ̀ɽɔ̀cɔ́	v ɒ ɹ ɒ tʃ ɒ
vəlɛða	v ə l ɛ ð ɑ
vəlɛðɔŋnɔ	v ə l ɛ ð ɒ ŋ n ɒ
vəlɛðɛ	v ə l ɛ ð ɛ
vəlɛ̀ðàr	v ə l ɛ ð ɑ ɹ
və̀lèðà	v ə l ɛ ð ɑ
və̀lèðá	v ə l ɛ ð ɑ
və̀lèðɔ̀	v ə l ɛ ð ɒ
və̀lèðɔ́	v ə l ɛ ð ɒ
və̀lɛ̀cìðá	v ə l ɛ tʃ i ð ɑ
və̀lɛ̀cɔ́	v ə l ɛ tʃ ɒ
və̀lɛ̀ð	v ə l ɛ ð
və̀lɛ̀ða	v ə l ɛ ð ɑ
və̀lɛ̀ðà	v ə l ɛ ð ɑ
və̀lɛ̀ðàt̪á	v ə l ɛ ð ɑ t ɑ
və̀lɛ̀ðá	v ə l ɛ ð ɑ
və̀lɛ̀ðápríɲá	v ə l ɛ ð ɑ p ɹ i ɲ ɑ
və̀lɛ̀ðáŕ	v ə l ɛ ð ɑ ɹ
və̀lɛ̀ðátɛ́r	v ə l ɛ ð ɑ t ɛ ɹ
və̀lɛ̀ðát̪ɛ́	v ə l ɛ ð ɑ t ɛ
və̀lɛ̀ðát̪ɛ́r	v ə l ɛ ð ɑ t ɛ ɹ
və̀lɛ̀ðáŋ	v ə l ɛ ð ɑ ŋ
və̀lɛ̀ðáɲárɛ́	v ə l ɛ ð ɑ ɲ ɑ ɹ ɛ
və̀lɛ̀ðâl	v ə l ɛ ð ɑ l
və̀lɛ̀ðǎ	v ə l ɛ ð ɑ
və̀lɛ̀ðìjí	v ə l ɛ ð i j i
və̀lɛ̀ðìjɔ̀	v ə l ɛ ð i j ɒ
və̀lɛ̀ðìnɔ̀	v ə l ɛ ð i n ɒ
və̀lɛ̀ðìnɔ́	v ə l ɛ ð i n ɒ
və̀lɛ̀ðìnɔ́r	v ə l ɛ ð i n ɒ ɹ
və̀lɛ̀ðíŋì	v ə l ɛ ð i ŋ i
və̀lɛ̀ðíɲárɛ́	v ə l ɛ ð i ɲ ɑ ɹ ɛ
və̀lɛ̀ðɔ̀	v ə l ɛ ð ɒ
və̀lɛ̀ðɔ́	v ə l ɛ ð ɒ
və̀lɛ̀ðɛ̀	v ə l ɛ ð ɛ
və̀lɛ̀ðɛ́ŋì	v ə l ɛ ð ɛ ŋ i
və̀lɛ̀ðɛ́ɲárɛ́	v ə l ɛ ð ɛ ɲ ɑ ɹ ɛ
və̀lɛ́ðátɛ́r	v ə l ɛ ð ɑ t ɛ ɹ
və̀rlɛ̀ða	v ə ɹ l ɛ ð ɑ
və̀rlɛ̀ðà	v ə ɹ l ɛ ð ɑ
və̀rlɛ̀ðàðɔ́	v ə ɹ l ɛ ð ɑ ð ɒ
və̀rlɛ̀ðɔ́	v ə ɹ l ɛ ð ɒ
və̀ɽàn	v ə ɹ ɑ n
və̀ɽìn	v ə ɹ i n
və̀ɽín	v ə ɹ i n
və́lɔ́ðínɔ́r	v ə l ɒ ð i n ɒ ɹ
və́lɛða	v ə l ɛ ð ɑ
və́lɛ̀ð	v ə l ɛ ð
və́lɛ̀ðà	v ə l ɛ ð ɑ
və́lɛ̀ðàló	v ə l ɛ ð ɑ l ow
və́lɛ̀ðàŕ	v ə l ɛ ð ɑ ɹ
və́lɛ̀ðàðà	v ə l ɛ ð ɑ ð ɑ
və́lɛ̀ðǎ	v ə l ɛ ð ɑ
və́lɛ̀ðìjɔ̀	v ə l ɛ ð i j ɒ
və́lɛ̀ðìnɔ̀	v ə l ɛ ð i n ɒ
və́lɛ̀ðìnɛ̀	v ə l ɛ ð i n ɛ
və́lɛ̀ðɔ̀	v ə l ɛ ð ɒ
və́lɛ̀ðɔ́	v ə l ɛ ð ɒ
və́lɛ̀ðɔ́ŕ	v ə l ɛ ð ɒ ɹ
və́lɛ̀ðɛ̀	v ə l ɛ ð ɛ
və́lɛ̀ðɛ̀ŕ	v ə l ɛ ð ɛ ɹ
və́lɛ̀ðɛ̌	v ə l ɛ ð ɛ
və́lɛ̀ðɛ̌l	v ə l ɛ ð ɛ l
və́lɛ́cí	v ə l ɛ tʃ i
və́lɛ́cír	v ə l ɛ tʃ i ɹ
və́lɛ́cíðúr	v ə l ɛ tʃ i ð ʉ ɹ
və́lɛ́ðà	v ə l ɛ ð ɑ
və́lɛ́ðátɛ́	v ə l ɛ ð ɑ t ɛ
və́lɛ́ðátɛ́r	v ə l ɛ ð ɑ t ɛ ɹ
və́lɛ́ðát̪ɔ́	v ə l ɛ ð ɑ t ɒ
və́lɛ́ðínɔ́	v ə l ɛ ð i n ɒ
və́lɛ́ðínɔ́r	v ə l ɛ ð i n ɒ ɹ
və́lɛ́ðɔ́	v ə l ɛ ð ɒ
və́lɛ́ðɔ́ŕ	v ə l ɛ ð ɒ ɹ
və́lɛ́ðɔ̂l	v ə l ɛ ð ɒ l
və́lɛ̂ðà	v ə l ɛ ð ɑ
və́lɛ̂ðàló	v ə l ɛ ð ɑ l ow
və́lɛ̂ðàlú	v ə l ɛ ð ɑ l ʉ
və́lɛ̂ðǎ	v ə l ɛ ð ɑ
və́lɛ̂ðɔ̀	v ə l ɛ ð ɒ
və́lɛ̂ðɔ́	v ə l ɛ ð ɒ
və́lɛ̂ðɛ̀	v ə l ɛ ð ɛ
və́lɛ̂ðɛ̀lú	v ə l ɛ ð ɛ l ʉ
və́lɛ̂ðɛ̌	v ə l ɛ ð ɛ
və́rlɛ̀ðàðà	v ə ɹ l ɛ ð ɑ ð ɑ
və́rlɛ̀ðàðɔ́	v ə ɹ l ɛ ð ɑ ð ɒ
və́ɽàn	v ə ɹ ɑ n
və́ɽán	v ə ɹ ɑ n
və́ɽân	v ə ɹ ɑ n
və́ɽìn	v ə ɹ i n
və́ɽín	v ə ɹ i n
və̂lɛ̀ðɛ̀	v ə l ɛ ð ɛ
vɜ̀rìi	v ɐ ɹ i i
vɜ̀ɽì	v ɐ ɹ i
vɜ̀ɽí	v ɐ ɹ i
vɜ̀ɽɔ́	v ɐ ɹ ɒ
vɜ̀ɾá	v ɐ ɾ ɑ
vɜ́ɽí	v ɐ ɹ i
vɜ́ɽící	v ɐ ɹ i tʃ i
vɜ́ɽɔ̀	v ɐ ɹ ɒ
vɜ́ɽ̀	v ɐ ɹ
vɜ́ɾó	v ɐ ɾ ow
vɽàn	v ɹ ɑ n
vɽàň	v ɹ ɑ n
vɽáń	v ɹ ɑ n
vɽân	v ɹ ɑ n
wàj	w ɑ j
wàjàcá	w ɑ j ɑ tʃ ɑ
wàlí	w ɑ l i
wàlír	w ɑ l i ɹ
wàló	w ɑ l ow
wàlʊ́	w ɑ l ʊ
wájácí	w ɑ j ɑ tʃ i
wájí	w ɑ j i
wálí	w ɑ l i
wálír	w ɑ l i ɹ
wáló	w ɑ l ow
wálʊ́	w ɑ l ʊ
wǎj	w ɑ j
wə̀rkɛ̌v	w ə ɹ k ɛ v
wɛn	w ɛ n
wɛ̀	w ɛ
wɛ̀n	w ɛ n
wɛ̀ń	w ɛ n
wɛ́	w ɛ
wɛ́n	w ɛ n
wɛ́nɛ́	w ɛ n ɛ
wɛ̌	w ɛ
wɛ̌n	w ɛ n
ð	ð
ða	ð ɑ
ðar	ð ɑ ɹ
ðart̪ɔlðɛ	ð ɑ ɹ t ɒ l ð ɛ
ðart̪ɔŋðɛ	ð ɑ ɹ t ɒ ŋ ð ɛ
ðà	ð ɑ
ðààrt̪ɔ́ðɛ́	ð ɑ ɑ ɹ t ɒ ð ɛ
ðàbà	ð ɑ b ɑ
ðàbrà	ð ɑ b ɹ ɑ
ðàbùðôl	ð ɑ b ʉ ð ow l
ðàbɽà	ð ɑ b ɹ ɑ
ðàgùbíjùíù	ð ɑ ɡ ʉ b i j ʉ i ʉ
ðàjɛ́ðì	ð ɑ j ɛ ð i
ðàl	ð ɑ l
ðàlagàrâj	ð ɑ l ɑ ɡ ɑ ɹ ɑ j
ðàlàgàràj	ð ɑ l ɑ ɡ ɑ ɹ ɑ j
ðàlàgàráj	ð ɑ l ɑ ɡ ɑ ɹ ɑ j
ðàlàgàrájɛ̀	ð ɑ l ɑ ɡ ɑ ɹ ɑ j ɛ
ðàlàgàrâj	ð ɑ l ɑ ɡ ɑ ɹ ɑ j
ðàlàgàrâǰ	ð ɑ l ɑ ɡ ɑ ɹ ɑ j
ðàlgàráì	ð ɑ l ɡ ɑ ɹ ɑ i
ðàlgàráj	ð ɑ l ɡ ɑ ɹ ɑ j
ðàlgàrájɛ̀	ð ɑ l ɡ ɑ ɹ ɑ j ɛ
ðàlgàrájɛ́	ð ɑ l ɡ ɑ ɹ ɑ j ɛ
ðàlgàrâj	ð ɑ l ɡ ɑ ɹ ɑ j
ðàlgàrâj́	ð ɑ l ɡ ɑ ɹ ɑ j
ðàlípí	ð ɑ l i p i
ðàlə̀ŋɔ̀ŋ	ð ɑ l ə ŋ ɒ ŋ
ðàlə̀ŋɔ́	ð ɑ l ə ŋ ɒ
ðàmàɲà	ð ɑ m ɑ ɲ ɑ
ðàmáðìnɛ̀	ð ɑ m ɑ ð i n ɛ
ðàmáð̀nɛ̀	ð ɑ m ɑ ð n ɛ
ðàmáɽð̀	ð ɑ m ɑ ɹ ð
ðàmɔ̀cò	ð ɑ m ɒ tʃ ow
ðàmɔ̀rðɔ́	ð ɑ m ɒ ɹ ð ɒ
ðàndà	ð ɑ n d ɑ
ðàó	ð ɑ ow
ðàr	ð ɑ ɹ
ðàríbì	ð ɑ ɹ i b i
ðàrt̪á	ð ɑ ɹ t ɑ
ðàrt̪áðɛ́	ð ɑ ɹ t ɑ ð ɛ
ðàrt̪ɔ́	ð ɑ ɹ t ɒ
ðàrt̪ɔ́l	ð ɑ ɹ t ɒ l
ðàrt̪ɔ́ðɛ́	ð ɑ ɹ t ɒ ð ɛ
ðàrt̪ɔ́ð́	ð ɑ ɹ t ɒ ð
ðàŕ	ð ɑ ɹ
ðàvə́lɛ̀ðɛ̀	ð ɑ v ə l ɛ ð ɛ
ðàvə́lɛ̂ðɛ̀	ð ɑ v ə l ɛ ð ɛ
ðàvə́lɛ̂ðɛ́	ð ɑ v ə l ɛ ð ɛ
ðàvə́lɛ̂ðɛ̌	ð ɑ v ə l ɛ ð ɛ
ðàðíkìðɔ̀	ð ɑ ð i k i ð ɒ
ðàðə́	ð ɑ ð ə
ðàðə́və̀lɛ̀ðà	ð ɑ ð ə v ə l ɛ ð ɑ
ðàðə́və̀lɛ̀ðɔ́	ð ɑ ð ə v ə l ɛ ð ɒ
ðàðɛ́	ð ɑ ð ɛ
ðàŋàl	ð ɑ ŋ ɑ l
ðàŋàlà	ð ɑ ŋ ɑ l ɑ
ðàŋàlǎ	ð ɑ ŋ ɑ l ɑ
ðàŋácínɛ̀	ð ɑ ŋ ɑ tʃ i n ɛ
ðàŋǎl	ð ɑ ŋ ɑ l
ðàŋvə́lɛ̂ðɛ̀	ð ɑ ŋ v ə l ɛ ð ɛ
ðàŋvə́lɛ̂ðɛ̌	ð ɑ ŋ v ə l ɛ ð ɛ
ðàŋɔ̀nɔ̀	ð ɑ ŋ ɒ n ɒ
ðàɾt̪íŋìðɛ	ð ɑ ɾ t i ŋ i ð ɛ
ðàɾt̪íŋí	ð ɑ ɾ t i ŋ i
ðàɾt̪ɔ́	ð ɑ ɾ t ɒ
ðàɾt̪ɔ́l	ð ɑ ɾ t ɒ l
ðàɾt̪ɔ́láŋàðɛ	ð ɑ ɾ t ɒ l ɑ ŋ ɑ ð ɛ
ðàɾɔ̌ðɛ́	ð ɑ ɾ ɒ ð ɛ
ðà́tɔ́	ð ɑ t ɒ
ðá	ð ɑ
ðábà	ð ɑ b ɑ
ðábrà	ð ɑ b ɹ ɑ
ðábrá	ð ɑ b ɹ ɑ
ðábr̀t̪à	ð ɑ b ɹ t ɑ
ðábŕt̪á	ð ɑ b ɹ t ɑ
ðábùðà	ð ɑ b ʉ ð ɑ
ðábút̪à	ð ɑ b ʉ t ɑ
ðábút̪á	ð ɑ b ʉ t ɑ
ðábúðá	ð ɑ b ʉ ð ɑ
ðádíjà	ð ɑ d i j ɑ
ðádíjǎ	ð ɑ d i j ɑ
ðádɔ́ŋnɔ́	ð ɑ d ɒ ŋ n ɒ
ðáìjɔ́	ð ɑ i j ɒ
ðáí	ð ɑ i
ðáíjà	ð ɑ i j ɑ
ðáíjánó	ð ɑ i j ɑ n ow
ðájà	ð ɑ j ɑ
ðájá	ð ɑ j ɑ
ðájéðà	ð ɑ j ɛ ð ɑ
ðájɛ̂ðà	ð ɑ j ɛ ð ɑ
ðál	ð ɑ l
ðálgàráj	ð ɑ l ɡ ɑ ɹ ɑ j
ðálgàrâj	ð ɑ l ɡ ɑ ɹ ɑ j
ðálvə̀lɛ̀ðɛ̀	ð ɑ l v ə l ɛ ð ɛ
ðálə̀ŋà	ð ɑ l ə ŋ ɑ
ðálə̀ŋɔ̀ŋ	ð ɑ l ə ŋ ɒ ŋ
ðálə̀ŋɔ́	ð ɑ l ə ŋ ɒ
ðálə̀ŋɔ́ŋ	ð ɑ l ə ŋ ɒ ŋ
ðálə̀ŋɔ̌ŋ	ð ɑ l ə ŋ ɒ ŋ
ðálə́gàrájɛ́	ð ɑ l ə ɡ ɑ ɹ ɑ j ɛ
ðálə́gàrâǰ	ð ɑ l ə ɡ ɑ ɹ ɑ j
ðálə́ŋà	ð ɑ l ə ŋ ɑ
ðálə́ŋá	ð ɑ l ə ŋ ɑ
ðámàcà	ð ɑ m ɑ tʃ ɑ
ðámá	ð ɑ m ɑ
ðámácá	ð ɑ m ɑ tʃ ɑ
ðámágðɛ́ðá	ð ɑ m ɑ ɡ ð ɛ ð ɑ
ðámákðɛ́ðá	ð ɑ m ɑ k ð ɛ ð ɑ
ðámáðìnɔ̀	ð ɑ m ɑ ð i n ɒ
ðámìɲaciðɛ	ð ɑ m i ɲ ɑ tʃ i ð ɛ
ðámìɲà	ð ɑ m i ɲ ɑ
ðámìɲàcíðɛ́	ð ɑ m i ɲ ɑ tʃ i ð ɛ
ðámìɲiðɛ́	ð ɑ m i ɲ i ð ɛ
ðámìɲí	ð ɑ m i ɲ i
ðámìɲíðɛ́	ð ɑ m i ɲ i ð ɛ
ðámíɲá	ð ɑ m i ɲ ɑ
ðámlá	ð ɑ m l ɑ
ðámlâ	ð ɑ m l ɑ
ðámɛ̀	ð ɑ m ɛ
ðánt̪ɔ̀	ð ɑ n t ɒ
ðánt̪ɔ́	ð ɑ n t ɒ
ðáò	ð ɑ ow
ðáó	ð ɑ ow
ðápà	ð ɑ p ɑ
ðápàt̪ɛ̀	ð ɑ p ɑ t ɛ
ðápá	ð ɑ p ɑ
ðáprí	ð ɑ p ɹ i
ðápríját̪à	ð ɑ p ɹ i j ɑ t ɑ
ðáprít̪òo	ð ɑ p ɹ i t ow ow
ðápə̀ɽìnɔ́	ð ɑ p ə ɹ i n ɒ
ðápə́ɽìnɔ̀	ð ɑ p ə ɹ i n ɒ
ðár	ð ɑ ɹ
ðárà	ð ɑ ɹ ɑ
ðárá	ð ɑ ɹ ɑ
ðárò	ð ɑ ɹ ow
ðárðà	ð ɑ ɹ ð ɑ
ðáŕ	ð ɑ ɹ
ðáúdà	ð ɑ ʉ d ɑ
ðávà	ð ɑ v ɑ
ðávìðàcà	ð ɑ v i ð ɑ tʃ ɑ
ðávə̀lɛ̀ðà	ð ɑ v ə l ɛ ð ɑ
ðávə̀lɛ̀ðɔ́	ð ɑ v ə l ɛ ð ɒ
ðávə́lɛ̀ðà	ð ɑ v ə l ɛ ð ɑ
ðáwà	ð ɑ w ɑ
ðáwá	ð ɑ w ɑ
ðáðə́	ð ɑ ð ə
ðáðɛ́	ð ɑ ð ɛ
ðáŋà	ð ɑ ŋ ɑ
ðáŋàl	ð ɑ ŋ ɑ l
ðáŋàlà	ð ɑ ŋ ɑ l ɑ
ðáŋàlàùnɛ́rɛ̂	ð ɑ ŋ ɑ l ɑ ʉ n ɛ ɹ ɛ
ðáŋàlǎ	ð ɑ ŋ ɑ l ɑ
ðáŋá	ð ɑ ŋ ɑ
ðáŋál	ð ɑ ŋ ɑ l
ðáŋâl	ð ɑ ŋ ɑ l
ðáŋâlà	ð ɑ ŋ ɑ l ɑ
ðáŋâlǎ	ð ɑ ŋ ɑ l ɑ
ðáŋǎl	ð ɑ ŋ ɑ l
ðáŋɔ̀ŋnìjɔ̀	ð ɑ ŋ ɒ ŋ n i j ɒ
ðáŋɔ̀ŋnɔ̀	ð ɑ ŋ ɒ ŋ n ɒ
ðáŋɔ́ŋníjɔ́	ð ɑ ŋ ɒ ŋ n i j ɒ
ðáŋɔ́ŋnɔ́	ð ɑ ŋ ɒ ŋ n ɒ
ðáɔ́ŋɔ̀ŋnɔ̀	ð ɑ ɒ ŋ ɒ ŋ n ɒ
ðáɲì	ð ɑ ɲ i
ðáɽà	ð ɑ ɹ ɑ
ðáɽá	ð ɑ ɹ ɑ
ðáɽìðà	ð ɑ ɹ i ð ɑ
ðáɽíðá	ð ɑ ɹ i ð ɑ
ðáɽŋát̪à	ð ɑ ɹ ŋ ɑ t ɑ
ðáɽə̀ŋàt̪à	ð ɑ ɹ ə ŋ ɑ t ɑ
ðáɽə́ŋát̪á	ð ɑ ɹ ə ŋ ɑ t ɑ
ðáɾà	ð ɑ ɾ ɑ
ðáɾá	ð ɑ ɾ ɑ
ðáɾɔ́ðɛ́	ð ɑ ɾ ɒ ð ɛ
ðâj	ð ɑ j
ðâjèðɔ́	ð ɑ j ɛ ð ɒ
ðâmàðìnɔ́	ð ɑ m ɑ ð i n ɒ
ðâr	ð ɑ ɹ
ðâré	ð ɑ ɹ ɛ
ðâvlɛ̀ðɔ́	ð ɑ v l ɛ ð ɒ
ðâŋàl	ð ɑ ŋ ɑ l
ðǎ	ð ɑ
ðǎl̀və̀lɛ̀ðɛ̀	ð ɑ l v ə l ɛ ð ɛ
ðǎpàt̪ɛ̀	ð ɑ p ɑ t ɛ
ðǎpɾ	ð ɑ p ɾ
ðǎr	ð ɑ ɹ
ðǎvə́lɛ̂ðà	ð ɑ v ə l ɛ ð ɑ
ðǎŋóvə́lɛ̂ðǎ	ð ɑ ŋ ow v ə l ɛ ð ɑ
ðǎŋvə́lɛ̂ðà	ð ɑ ŋ v ə l ɛ ð ɑ
ðǎŋvə́lɛ̂ðǎ	ð ɑ ŋ v ə l ɛ ð ɑ
ðǎɽíɲà	ð ɑ ɹ i ɲ ɑ
ðèɽà	ð ɛ ɹ ɑ
ðé	ð ɛ
ðìcèlò	ð i tʃ ɛ l ow
ðìclò	ð i tʃ l ow
ðìcò	ð i tʃ ow
ðìcùlò	ð i tʃ ʉ l ow
ðìcùlù	ð i tʃ ʉ l ʉ
ðìcùlɔ̀	ð i tʃ ʉ l ɒ
ðìcúɾɔ̀	ð i tʃ ʉ ɾ ɒ
ðìcɔ̀	ð i tʃ ɒ
ðìcɔ̀ɔ̌	ð i tʃ ɒ ɒ
ðìcə̀lò	ð i tʃ ə l ow
ðìcə̀lǒ	ð i tʃ ə l ow
ðìdù	ð i d ʉ
ðìdú	ð i d ʉ
ðìdɔ̀t̪ɔ́	ð i d ɒ t ɒ
ðìjèðú	ð i j ɛ ð ʉ
ðìjó	ð i j ow
ðìjɔ̀	ð i j ɒ
ðìjɔ́	ð i j ɒ
ðìjɛ̀ðú	ð i j ɛ ð ʉ
ðìnɔ̀	ð i n ɒ
ðìnɔ́	ð i n ɒ
ðìrt̪ɔ́	ð i ɹ t ɒ
ðìrt̪ɔ́ðɛ́	ð i ɹ t ɒ ð ɛ
ðìt̪rɔ́	ð i t ɹ ɒ
ðìt̪rɛ̂	ð i t ɹ ɛ
ðìt̪ɾɛ́	ð i t ɾ ɛ
ðìŋgə̀lá	ð i ŋ ɡ ə l ɑ
ðìɲánó	ð i ɲ ɑ n ow
ðìɲó	ð i ɲ ow
ðìɲú	ð i ɲ ʉ
ðíbɔ̀	ð i b ɒ
ðíbɔ́	ð i b ɒ
ðícìlà	ð i tʃ i l ɑ
ðícìlò	ð i tʃ i l ow
ðícìŋgɛ̀làlà	ð i tʃ i ŋ ɡ ɛ l ɑ l ɑ
ðícílá	ð i tʃ i l ɑ
ðícíŋgɛ́lálá	ð i tʃ i ŋ ɡ ɛ l ɑ l ɑ
ðícɔ̀	ð i tʃ ɒ
ðícɔ́	ð i tʃ ɒ
ðídìjɔ́	ð i d i j ɒ
ðídìjɔ́l	ð i d i j ɒ l
ðídí	ð i d i
ðídɔ̀	ð i d ɒ
ðídɔ̀t̪ɔ̀	ð i d ɒ t ɒ
ðídɔ́	ð i d ɒ
ðíd̪í	ð i d i
ðíjà	ð i j ɑ
ðíjá	ð i j ɑ
ðíjǎ	ð i j ɑ
ðíjɔ̀	ð i j ɒ
ðíjɛ̀ðà	ð i j ɛ ð ɑ
ðíjɛ́	ð i j ɛ
ðíjɛ́ðá	ð i j ɛ ð ɑ
ðíkìðɔ̀	ð i k i ð ɒ
ðílìcò	ð i l i tʃ ow
ðílɔ̀ðɔ̀	ð i l ɒ ð ɒ
ðílɔ́ðɔ́	ð i l ɒ ð ɒ
ðínd̪ɔ̀t̪ɔ̀	ð i n d ɒ t ɒ
ðínd̪ɔ́t̪ɔ́	ð i n d ɒ t ɒ
ðínɔ̀	ð i n ɒ
ðínɔ́	ð i n ɒ
ðírcɔ̀	ð i ɹ tʃ ɒ
ðírcə́cɔ̀	ð i ɹ tʃ ə tʃ ɒ
ðírcə́cɔ́	ð i ɹ tʃ ə tʃ ɒ
ðírìcɛ̀cɔ̀	ð i ɹ i tʃ ɛ tʃ ɒ
ðírícɛ́cɔ́	ð i ɹ i tʃ ɛ tʃ ɒ
ðíðɔ̀	ð i ð ɒ
ðíðɔ́	ð i ð ɒ
ðíɲàðɛ̀rɛ̀	ð i ɲ ɑ ð ɛ ɹ ɛ
ðíɲàðɛ̀rɛ́	ð i ɲ ɑ ð ɛ ɹ ɛ
ðíɲàðɛ̌	ð i ɲ ɑ ð ɛ
ðíɲâcì	ð i ɲ ɑ tʃ i
ðíɲí	ð i ɲ i
ðíɲî	ð i ɲ i
ðíɲú	ð i ɲ ʉ
ðíɲɔ̀	ð i ɲ ɒ
ðíɲɔ́	ð i ɲ ɒ
ðî	ð i
ðîjà	ð i j ɑ
ðlá	ð l ɑ
ðòlà	ð ow l ɑ
ðòndà	ð ow n d ɑ
ðònɽà	ð ow n ɹ ɑ
ðòɽáɾ	ð ow ɹ ɑ ɾ
ðòɽáɾɛ́	ð ow ɹ ɑ ɾ ɛ
ðó	ð ow
ðólá	ð ow l ɑ
ðów	ð ow w
ðówɛ̀	ð ow w ɛ
ðówɛ́	ð ow w ɛ
ðóɾà	ð ow ɾ ɑ
ðóɾó	ð ow ɾ ow
ðóɾɛ̀	ð ow ɾ ɛ
ðô	ð ow
ðôɾà	ð ow ɾ ɑ
ðpɔ́	ð p ɒ
ðràvà	ð ɹ ɑ v ɑ
ðràvì	ð ɹ ɑ v i
ðrɔ́	ð ɹ ɒ
ðrɛ́ɽí	ð ɹ ɛ ɹ i
ðt̪ɾɛ́	ð t ɾ ɛ
ðù	ð ʉ
ðùcùbù	ð ʉ tʃ ʉ b ʉ
ðùdò	ð ʉ d ow
ðùd̪ɔ̀	ð ʉ d ɒ
ðùgùbúlɔ̀	ð ʉ ɡ ʉ b ʉ l ɒ
ðùgùbúlɔ́	ð ʉ ɡ ʉ b ʉ l ɒ
ðùpà	ð ʉ p ɑ
ðùɽár	ð ʉ ɹ ɑ ɹ
ðùɽárɛ́	ð ʉ ɹ ɑ ɹ ɛ
ðùɽi	ð ʉ ɹ i
ðùɽì	ð ʉ ɹ i
ðùɽí	ð ʉ ɹ i
ðùɽù	ð ʉ ɹ ʉ
ðùɽùbú	ð ʉ ɹ ʉ b ʉ
ðùɽú	ð ʉ ɹ ʉ
ðùɽúðɛ̀	ð ʉ ɹ ʉ ð ɛ
ðùɽúðɛ́	ð ʉ ɹ ʉ ð ɛ
ðú	ð ʉ
ðúdò	ð ʉ d ow
ðúdɔ̀	ð ʉ d ɒ
ðúdɔ́	ð ʉ d ɒ
ðúd̪ɔ̀	ð ʉ d ɒ
ðúd̪ɔ̌	ð ʉ d ɒ
ðúmɔ̀ðɔ̀	ð ʉ m ɒ ð ɒ
ðúmɔ́ðɔ́	ð ʉ m ɒ ð ɒ
ðúpà	ð ʉ p ɑ
ðúpǎ	ð ʉ p ɑ
ðúrmùðɔ́ðɛ́	ð ʉ ɹ m ʉ ð ɒ ð ɛ
ðúrmʊ̀ðɔ̀	ð ʉ ɹ m ʊ ð ɒ
ðúrmʊ́ðɔ́	ð ʉ ɹ m ʊ ð ɒ
ðúrɔ̀	ð ʉ ɹ ɒ
ðúrɔ́	ð ʉ ɹ ɒ
ðútìðɔ̀	ð ʉ t i ð ɒ
ðútíðɔ́	ð ʉ t i ð ɒ
ðúvɛ̀	ð ʉ v ɛ
ðúɽár	ð ʉ ɹ ɑ ɹ
ðúɽcà	ð ʉ ɹ tʃ ɑ
ðúɽcá	ð ʉ ɹ tʃ ɑ
ðúɽi	ð ʉ ɹ i
ðúɽì	ð ʉ ɹ i
ðúɽìðà	ð ʉ ɹ i ð ɑ
ðúɽí	ð ʉ ɹ i
ðúɽít̪á	ð ʉ ɹ i t ɑ
ðúɽíðá	ð ʉ ɹ i ð ɑ
ðúɽíðát̪á	ð ʉ ɹ i ð ɑ t ɑ
ðúɽó	ð ʉ ɹ ow
ðúɽór	ð ʉ ɹ ow ɹ
ðúɽùbǔ	ð ʉ ɹ ʉ b ʉ
ðúɽû	ð ʉ ɹ ʉ
ðúɽðìðɔ̀	ð ʉ ɹ ð i ð ɒ
ðúɽðíðɔ́	ð ʉ ɹ ð i ð ɒ
ðúɾmùðɔ́ðɛ̀	ð ʉ ɾ m ʉ ð ɒ ð ɛ
ðɔ̀	ð ɒ
ðɔ̀cà	ð ɒ tʃ ɑ
ðɔ̀cɔ̀	ð ɒ tʃ ɒ
ðɔ̀iɲá	ð ɒ i ɲ ɑ
ðɔ̀la	ð ɒ l ɑ
ðɔ̀là	ð ɒ l ɑ
ðɔ̀lá	ð ɒ l ɑ
ðɔ̀lǎ	ð ɒ l ɑ
ðɔ̀mɔ̀cà	ð ɒ m ɒ tʃ ɑ
ðɔ̀mɔ̀cǎ	ð ɒ m ɒ tʃ ɑ
ðɔ̀mɔ̀cɔ̀	ð ɒ m ɒ tʃ ɒ
ðɔ̀mɔ̀cɔ̌	ð ɒ m ɒ tʃ ɒ
ðɔ̀n	ð ɒ n
ðɔ̀ndà	ð ɒ n d ɑ
ðɔ̀ndɔ̀	ð ɒ n d ɒ
ðɔ̀ɲa	ð ɒ ɲ ɑ
ðɔ̀ɽár	ð ɒ ɹ ɑ ɹ
ðɔ̀ɽárɛ̀	ð ɒ ɹ ɑ ɹ ɛ
ðɔ́	ð ɒ
ðɔ́cɔ̀	ð ɒ tʃ ɒ
ðɔ́dà	ð ɒ d ɑ
ðɔ́dá	ð ɒ d ɑ
ðɔ́dɔ́	ð ɒ d ɒ
ðɔ́là	ð ɒ l ɑ
ðɔ́lá	ð ɒ l ɑ
ðɔ́màcà	ð ɒ m ɑ tʃ ɑ
ðɔ́mɔ̀cà	ð ɒ m ɒ tʃ ɑ
ðɔ́mɔ̀cá	ð ɒ m ɒ tʃ ɑ
ðɔ́mɔ̀cɔ̀	ð ɒ m ɒ tʃ ɒ
ðɔ́mɔ̀ŋnɔ̀	ð ɒ m ɒ ŋ n ɒ
ðɔ́mɔ́cà	ð ɒ m ɒ tʃ ɑ
ðɔ́mɔ́ŋnɔ́	ð ɒ m ɒ ŋ n ɒ
ðɔ́ndà	ð ɒ n d ɑ
ðɔ́ndɔ̀	ð ɒ n d ɒ
ðɔ́ndɔ̌	ð ɒ n d ɒ
ðɔ́rndì	ð ɒ ɹ n d i
ðɔ́rndɔ̀	ð ɒ ɹ n d ɒ
ðɔ́rndɛ̀	ð ɒ ɹ n d ɛ
ðɔ́rt̪ɔ̀	ð ɒ ɹ t ɒ
ðɔ́tɔ́	ð ɒ t ɒ
ðɔ́t̪ɔ̀	ð ɒ t ɒ
ðɔ́ŋɔ̀ŋnìjɔ̀	ð ɒ ŋ ɒ ŋ n i j ɒ
ðɔ́ŋɔ̀ŋnɔ̀	ð ɒ ŋ ɒ ŋ n ɒ
ðɔ́ŋɔ́ŋníjɔ́	ð ɒ ŋ ɒ ŋ n i j ɒ
ðɔ́ŋɔ́ŋnɔ́	ð ɒ ŋ ɒ ŋ n ɒ
ðɔ́ɟɔ́	ð ɒ dʒ ɒ
ðɔ́ɽà	ð ɒ ɹ ɑ
ðɔ́ɽá	ð ɒ ɹ ɑ
ðɔ́ɽdà	ð ɒ ɹ d ɑ
ðɔ́ɽɟɛ̀cà	ð ɒ ɹ dʒ ɛ tʃ ɑ
ðɔ́ɽɟɛ́cá	ð ɒ ɹ dʒ ɛ tʃ ɑ
ðɔ́ɾà	ð ɒ ɾ ɑ
ðɔ́ɾɛ́	ð ɒ ɾ ɛ
ðɔ̂	ð ɒ
ðɔ̂n	ð ɒ n
ðɔ̂ndà	ð ɒ n d ɑ
ðɔ̂t̪à	ð ɒ t ɑ
ðɔ̌t̪ɔ̂	ð ɒ t ɒ
ðəkàðá	ð ə k ɑ ð ɑ
ðəmaɲa	ð ə m ɑ ɲ ɑ
ðəvə̀lɛ̀ðɔ́	ð ə v ə l ɛ ð ɒ
ðəvə̀lɛ̀ðɔ́ŋ	ð ə v ə l ɛ ð ɒ ŋ
ðə̀	ð ə
ðə̀bùlìjí	ð ə b ʉ l i j i
ðə̀bɽà	ð ə b ɹ ɑ
ðə̀cə̀lò	ð ə tʃ ə l ow
ðə̀dú	ð ə d ʉ
ðə̀dɔ̀ɽɔ̀	ð ə d ɒ ɹ ɒ
ðə̀dɛ̀ɽì	ð ə d ɛ ɹ i
ðə̀d̪ùɾɔ̀t̪ɔ́	ð ə d ʉ ɾ ɒ t ɒ
ðə̀gàrɔ́	ð ə ɡ ɑ ɹ ɒ
ðə̀gàɾɔ́	ð ə ɡ ɑ ɾ ɒ
ðə̀gʊ̀bʊ́l	ð ə ɡ ʊ b ʊ l
ðə̀gʊ̀bʊ́lɔ̀	ð ə ɡ ʊ b ʊ l ɒ
ðə̀gʊ̀bʊ̂l	ð ə ɡ ʊ b ʊ l
ðə̀làɽà	ð ə l ɑ ɹ ɑ
ðə̀láɽà	ð ə l ɑ ɹ ɑ
ðə̀láɽá	ð ə l ɑ ɹ ɑ
ðə̀lə̀ŋà	ð ə l ə ŋ ɑ
ðə̀lə̀ŋàðɛ̀	ð ə l ə ŋ ɑ ð ɛ
ðə̀lə̀ŋàðɛ̌	ð ə l ə ŋ ɑ ð ɛ
ðə̀lə̀ŋǎ	ð ə l ə ŋ ɑ
ðə̀màn	ð ə m ɑ n
ðə̀mànɲà	ð ə m ɑ n ɲ ɑ
ðə̀màðìnɔ̀	ð ə m ɑ ð i n ɒ
ðə̀màðìnɔ́	ð ə m ɑ ð i n ɒ
ðə̀màɲ	ð ə m ɑ ɲ
ðə̀màɲà	ð ə m ɑ ɲ ɑ
ðə̀máɽðà	ð ə m ɑ ɹ ð ɑ
ðə̀máɽðá	ð ə m ɑ ɹ ð ɑ
ðə̀mɔ̀cɔ́	ð ə m ɒ tʃ ɒ
ðə̀mɜ̀ðìnɔ́	ð ə m ɐ ð i n ɒ
ðə̀ndà	ð ə n d ɑ
ðə̀nɔ̀nɔ̀	ð ə n ɒ n ɒ
ðə̀nɔ̀nɔ́	ð ə n ɒ n ɒ
ðə̀pí	ð ə p i
ðə̀píŋí	ð ə p i ŋ i
ðə̀pɔ́	ð ə p ɒ
ðə̀râw	ð ə ɹ ɑ w
ðə̀rǎw	ð ə ɹ ɑ w
ðə̀rlànd̪ɔ́	ð ə ɹ l ɑ n d ɒ
ðə̀rnà	ð ə ɹ n ɑ
ðə̀rɔ́	ð ə ɹ ɒ
ðə̀rə̀vɛ́	ð ə ɹ ə v ɛ
ðə̀tə̀vá	ð ə t ə v ɑ
ðə̀tɾɛ́	ð ə t ɾ ɛ
ðə̀t̪ə̀vá	ð ə t ə v ɑ
ðə̀t̪ɾɔ̀	ð ə t ɾ ɒ
ðə̀t̪ɾɛ̀	ð ə t ɾ ɛ
ðə̀t̪ɾɛ́	ð ə t ɾ ɛ
ðə̀vé	ð ə v ɛ
ðə̀vlɛ̀ðɔ̀ŋ	ð ə v l ɛ ð ɒ ŋ
ðə̀vlɛ̀ðɔ́	ð ə v l ɛ ð ɒ
ðə̀vlɛ̀ðɔ́ŋ	ð ə v l ɛ ð ɒ ŋ
ðə̀və̀lèðɔ̀	ð ə v ə l ɛ ð ɒ
ðə̀və̀lèðɔ̀ŋ	ð ə v ə l ɛ ð ɒ ŋ
ðə̀və̀lèðɔ́	ð ə v ə l ɛ ð ɒ
ðə̀və̀lèðɔ́ŋ	ð ə v ə l ɛ ð ɒ ŋ
ðə̀və̀lɛ̀ðáŋá	ð ə v ə l ɛ ð ɑ ŋ ɑ
ðə̀və̀lɛ̀ðɔ̀	ð ə v ə l ɛ ð ɒ
ðə̀və̀lɛ̀ðɔ́	ð ə v ə l ɛ ð ɒ
ðə̀və̀lɛ̀ðɔ́ŋ	ð ə v ə l ɛ ð ɒ ŋ
ðə̀və̀lɛ̀ðɔ́ŋó	ð ə v ə l ɛ ð ɒ ŋ ow
ðə̀və̀lɛ̀ðɔ́ŋʊ̀	ð ə v ə l ɛ ð ɒ ŋ ʊ
ðə̀və̀lɛ̀ðɛ́ŋí	ð ə v ə l ɛ ð ɛ ŋ i
ðə̀və̀lɛ̀ðɛ́ŋî	ð ə v ə l ɛ ð ɛ ŋ i
ðə̀və̀lɛ́ðɔ́	ð ə v ə l ɛ ð ɒ
ðə̀ŋàcìnɔ́	ð ə ŋ ɑ tʃ i n ɒ
ðə̀ŋèɾò	ð ə ŋ ɛ ɾ ow
ðə̀ŋgə̀lá	ð ə ŋ ɡ ə l ɑ
ðə̀ŋɛ̀ɾà	ð ə ŋ ɛ ɾ ɑ
ðə̀ŋɛ̀ɾɔ̀	ð ə ŋ ɛ ɾ ɒ
ðə̀ɽà	ð ə ɹ ɑ
ðə̀ɽiŋàt̪ɔ́l	ð ə ɹ i ŋ ɑ t ɒ l
ðə̀ɽʊ̀	ð ə ɹ ʊ
ðə́bə̀ɽɔ̀	ð ə b ə ɹ ɒ
ðə́bə́ɽɔ́	ð ə b ə ɹ ɒ
ðə́dúrɔ́	ð ə d ʉ ɹ ɒ
ðə́dɔ̀	ð ə d ɒ
ðə́dɔ̀ŋnà	ð ə d ɒ ŋ n ɑ
ðə́dɔ̀ŋðà	ð ə d ɒ ŋ ð ɑ
ðə́dɔ́ŋðá	ð ə d ɒ ŋ ð ɑ
ðə́gàró	ð ə ɡ ɑ ɹ ow
ðə́gàɾà	ð ə ɡ ɑ ɾ ɑ
ðə́gàɾàt̪íŋí	ð ə ɡ ɑ ɾ ɑ t i ŋ i
ðə́gáɾá	ð ə ɡ ɑ ɾ ɑ
ðə́gìðɔ̀	ð ə ɡ i ð ɒ
ðə́gìɲàt̪íŋí	ð ə ɡ i ɲ ɑ t i ŋ i
ðə́gíðɔ́	ð ə ɡ i ð ɒ
ðə́gɔ̀cɔ̀	ð ə ɡ ɒ tʃ ɒ
ðə́gɛ́lcá	ð ə ɡ ɛ l tʃ ɑ
ðə́kèɲà	ð ə k ɛ ɲ ɑ
ðə́kìðɔ̀	ð ə k i ð ɒ
ðə́kíðɔ́	ð ə k i ð ɒ
ðə́kɔ̀cɔ̀	ð ə k ɒ tʃ ɒ
ðə́kə̀lcà	ð ə k ə l tʃ ɑ
ðə́kə̀lcǎ	ð ə k ə l tʃ ɑ
ðə́làcà	ð ə l ɑ tʃ ɑ
ðə́lá	ð ə l ɑ
ðə́lácá	ð ə l ɑ tʃ ɑ
ðə́láɽá	ð ə l ɑ ɹ ɑ
ðə́lɔ̀ɽíŋ	ð ə l ɒ ɹ i ŋ
ðə́lɔ̀ɽíŋí	ð ə l ɒ ɹ i ŋ i
ðə́lə̀ŋà	ð ə l ə ŋ ɑ
ðə́lɛ̀vcà	ð ə l ɛ v tʃ ɑ
ðə́lɛ̀ŋcà	ð ə l ɛ ŋ tʃ ɑ
ðə́lɛ́vcá	ð ə l ɛ v tʃ ɑ
ðə́lɛ́ŋcá	ð ə l ɛ ŋ tʃ ɑ
ðə́mà	ð ə m ɑ
ðə́màɲ	ð ə m ɑ ɲ
ðə́má	ð ə m ɑ
ðə́máɽðá	ð ə m ɑ ɹ ð ɑ
ðə́míɲà	ð ə m i ɲ ɑ
ðə́míɲá	ð ə m i ɲ ɑ
ðə́mùt̪ə̀nɔ̀	ð ə m ʉ t ə n ɒ
ðə́mút̪ə́nɔ́	ð ə m ʉ t ə n ɒ
ðə́mɛ̀ðà	ð ə m ɛ ð ɑ
ðə́mɛ́ðá	ð ə m ɛ ð ɑ
ðə́ndà	ð ə n d ɑ
ðə́ndá	ð ə n d ɑ
ðə́nɔ̀nà	ð ə n ɒ n ɑ
ðə́nɔ́ná	ð ə n ɒ n ɑ
ðə́nɔ̂nà	ð ə n ɒ n ɑ
ðə́pínɔ́	ð ə p i n ɒ
ðə́píðɔ́	ð ə p i ð ɒ
ðə́pɔ̀	ð ə p ɒ
ðə́pɔ́	ð ə p ɒ
ðə́r	ð ə ɹ
ðə́rà	ð ə ɹ ɑ
ðə́ràcà	ð ə ɹ ɑ tʃ ɑ
ðə́rá	ð ə ɹ ɑ
ðə́rácá	ð ə ɹ ɑ tʃ ɑ
ðə́rlànd̪à	ð ə ɹ l ɑ n d ɑ
ðə́rlánd̪á	ð ə ɹ l ɑ n d ɑ
ðə́rlɛ́ɲɔ́	ð ə ɹ l ɛ ɲ ɒ
ðə́rðá	ð ə ɹ ð ɑ
ðə́rɟɛ̀cɔ̀	ð ə ɹ dʒ ɛ tʃ ɒ
ðə́rɲàɲɛ̀	ð ə ɹ ɲ ɑ ɲ ɛ
ðə́r̀lànd̪ɔ́	ð ə ɹ l ɑ n d ɒ
ðə́r̀lɛ̀ɲɔ̀	ð ə ɹ l ɛ ɲ ɒ
ðə́tóðà	ð ə t ow ð ɑ
ðə́tóðá	ð ə t ow ð ɑ
ðə́tùtɔ̀	ð ə t ʉ t ɒ
ðə́tútɔ́	ð ə t ʉ t ɒ
ðə́tɔ̀ɽà	ð ə t ɒ ɹ ɑ
ðə́tɾɛ́	ð ə t ɾ ɛ
ðə́t̪à	ð ə t ɑ
ðə́t̪á	ð ə t ɑ
ðə́t̪ɔ̀	ð ə t ɒ
ðə́t̪ɔ̀t̪à	ð ə t ɒ t ɑ
ðə́t̪ɔ́	ð ə t ɒ
ðə́t̪ɔ́t̪á	ð ə t ɒ t ɑ
ðə́t̪ɔ́ɽá	ð ə t ɒ ɹ ɑ
ðə́t̪ə̀và	ð ə t ə v ɑ
ðə́t̪ə́và	ð ə t ə v ɑ
ðə́t̪ə́vá	ð ə t ə v ɑ
ðə́t̪ə́vǎ	ð ə t ə v ɑ
ðə́t̪ɾɔ́	ð ə t ɾ ɒ
ðə́t̪ɾɛ́	ð ə t ɾ ɛ
ðə́váɾá	ð ə v ɑ ɾ ɑ
ðə́vŕðɔ́	ð ə v ɹ ð ɒ
ðə́vər̀lɛ̀ðà	ð ə v ə ɹ l ɛ ð ɑ
ðə́və̀lɔ̀cɔ̀	ð ə v ə l ɒ tʃ ɒ
ðə́və̀lɛ̀ðà	ð ə v ə l ɛ ð ɑ
ðə́və̀lɛ̀ðɔ́	ð ə v ə l ɛ ð ɒ
ðə́və̀rlɛ̀ðà	ð ə v ə ɹ l ɛ ð ɑ
ðə́və̀rlɛ̀ðɔ́	ð ə v ə ɹ l ɛ ð ɒ
ðə́və́lɔ́cɔ́	ð ə v ə l ɒ tʃ ɒ
ðə́və́lɛ̀ðɔ́	ð ə v ə l ɛ ð ɒ
ðə́və́lɛ́ðà	ð ə v ə l ɛ ð ɑ
ðə́və́lɛ́ðá	ð ə v ə l ɛ ð ɑ
ðə́və́lɛ́ðáló	ð ə v ə l ɛ ð ɑ l ow
ðə́və́lɛ́ðíɲárɛ́	ð ə v ə l ɛ ð i ɲ ɑ ɹ ɛ
ðə́vɜ̀ɽɔ̀	ð ə v ɐ ɹ ɒ
ðə́vɜ́ɽɔ́	ð ə v ɐ ɹ ɒ
ðə́wàjà	ð ə w ɑ j ɑ
ðə́wájá	ð ə w ɑ j ɑ
ðə́ðà	ð ə ð ɑ
ðə́ðá	ð ə ð ɑ
ðə́ðə̀ŋnɔ̀	ð ə ð ə ŋ n ɒ
ðə́ðə́ŋnɔ́	ð ə ð ə ŋ n ɒ
ðə́ðɜ̀ŋ̀nà	ð ə ð ɐ ŋ n ɑ
ðə́ŋàcà	ð ə ŋ ɑ tʃ ɑ
ðə́ŋácá	ð ə ŋ ɑ tʃ ɑ
ðə́ŋáŋá	ð ə ŋ ɑ ŋ ɑ
ðə́ŋə̀rðà	ð ə ŋ ə ɹ ð ɑ
ðə́ŋə́rðá	ð ə ŋ ə ɹ ð ɑ
ðə́ɟíðɔ̀	ð ə dʒ i ð ɒ
ðə́ɟíðɔ́	ð ə dʒ i ð ɒ
ðə́ɲə̀làcà	ð ə ɲ ə l ɑ tʃ ɑ
ðə́ɲə́lácá	ð ə ɲ ə l ɑ tʃ ɑ
ðə́ɽiŋàt̪ɔ́l	ð ə ɹ i ŋ ɑ t ɒ l
ðə́ɽìɲà	ð ə ɹ i ɲ ɑ
ðə́ɽí	ð ə ɹ i
ðə́ɽíɲá	ð ə ɹ i ɲ ɑ
ðə́ɽʊ́	ð ə ɹ ʊ
ðə́ɾɔ́ðà	ð ə ɾ ɒ ð ɑ
ðə̌r	ð ə ɹ
ðɛdɔɽɔ	ð ɛ d ɒ ɹ ɒ
ðɛ̀	ð ɛ
ðɛ̀cə̀lò	ð ɛ tʃ ə l ow
ðɛ̀dú	ð ɛ d ʉ
ðɛ̀dɔ̀ɽɔ̀	ð ɛ d ɒ ɹ ɒ
ðɛ̀dɔ̀ɽɔ̌	ð ɛ d ɒ ɹ ɒ
ðɛ̀dɛ̀ɽì	ð ɛ d ɛ ɹ i
ðɛ̀d̪ùɾɔ̀t̪ɔ́	ð ɛ d ʉ ɾ ɒ t ɒ
ðɛ̀kìðɔ́	ð ɛ k i ð ɒ
ðɛ̀lə̀ŋà	ð ɛ l ə ŋ ɑ
ðɛ̀màɲà	ð ɛ m ɑ ɲ ɑ
ðɛ̀t̪àló	ð ɛ t ɑ l ow
ðɛ̀t̪áj	ð ɛ t ɑ j
ðɛ̀t̪áló	ð ɛ t ɑ l ow
ðɛ̀t̪ɛ̀lí	ð ɛ t ɛ l i
ðɛ̀t̪ɛ̀lír	ð ɛ t ɛ l i ɹ
ðɛ̀t̪ɛ́n	ð ɛ t ɛ n
ðɛ̀və́lɛ̂ðɛ̀	ð ɛ v ə l ɛ ð ɛ
ðɛ̀ŋàcìnɔ́	ð ɛ ŋ ɑ tʃ i n ɒ
ðɛ̀ɲú	ð ɛ ɲ ʉ
ðɛ́	ð ɛ
ðɛ́árò	ð ɛ ɑ ɹ ow
ðɛ́áŋɔ́ŋníjɔ́	ð ɛ ɑ ŋ ɒ ŋ n i j ɒ
ðɛ́bùrŋà	ð ɛ b ʉ ɹ ŋ ɑ
ðɛ́búrŋá	ð ɛ b ʉ ɹ ŋ ɑ
ðɛ́dùrɔ̀	ð ɛ d ʉ ɹ ɒ
ðɛ́dúrɔ́	ð ɛ d ʉ ɹ ɒ
ðɛ́dɔ̀ɽɔ̀	ð ɛ d ɒ ɹ ɒ
ðɛ́gàrcà	ð ɛ ɡ ɑ ɹ tʃ ɑ
ðɛ́gìɲíŋì	ð ɛ ɡ i ɲ i ŋ i
ðɛ́gɔ́cɔ́	ð ɛ ɡ ɒ tʃ ɒ
ðɛ́gɛ̀lcà	ð ɛ ɡ ɛ l tʃ ɑ
ðɛ́gɛ́lcá	ð ɛ ɡ ɛ l tʃ ɑ
ðɛ́kéɲá	ð ɛ k ɛ ɲ ɑ
ðɛ́kùkù	ð ɛ k ʉ k ʉ
ðɛ́kɔ̀t̪à	ð ɛ k ɒ t ɑ
ðɛ́kɔ̀t̪ìnɔ̀	ð ɛ k ɒ t i n ɒ
ðɛ́kɔ́t̪á	ð ɛ k ɒ t ɑ
ðɛ́kɔ́t̪ínɔ́	ð ɛ k ɒ t i n ɒ
ðɛ́l	ð ɛ l
ðɛ́lìŋɛ̀t̪à	ð ɛ l i ŋ ɛ t ɑ
ðɛ́líŋt̪á	ð ɛ l i ŋ t ɑ
ðɛ́lùɽbí	ð ɛ l ʉ ɹ b i
ðɛ́lɔ̀ɽà	ð ɛ l ɒ ɹ ɑ
ðɛ́lɔ́ɽá	ð ɛ l ɒ ɹ ɑ
ðɛ́mùt̪ɔ̀	ð ɛ m ʉ t ɒ
ðɛ́mút̪ɔ́	ð ɛ m ʉ t ɒ
ðɛ́n	ð ɛ n
ðɛ́nà	ð ɛ n ɑ
ðɛ́ná	ð ɛ n ɑ
ðɛ́ní	ð ɛ n i
ðɛ́nɛ̀ðà	ð ɛ n ɛ ð ɑ
ðɛ́nɛ́ðá	ð ɛ n ɛ ð ɑ
ðɛ́r	ð ɛ ɹ
ðɛ́rdá	ð ɛ ɹ d ɑ
ðɛ́rd̪à	ð ɛ ɹ d ɑ
ðɛ́rlɔ́ɲɔ́	ð ɛ ɹ l ɒ ɲ ɒ
ðɛ́rʊ́ŋɔ́	ð ɛ ɹ ʊ ŋ ɒ
ðɛ́táj	ð ɛ t ɑ j
ðɛ́tǎj	ð ɛ t ɑ j
ðɛ́tɛ́n	ð ɛ t ɛ n
ðɛ́t̪áj	ð ɛ t ɑ j
ðɛ́t̪áló	ð ɛ t ɑ l ow
ðɛ́t̪ə́lí	ð ɛ t ə l i
ðɛ́t̪ɛ́n	ð ɛ t ɛ n
ðɛ́t̪ɜ́lɛ́r	ð ɛ t ɐ l ɛ ɹ
ðɛ́vàɾà	ð ɛ v ɑ ɾ ɑ
ðɛ́váɾá	ð ɛ v ɑ ɾ ɑ
ðɛ́vràðà	ð ɛ v ɹ ɑ ð ɑ
ðɛ́vráðá	ð ɛ v ɹ ɑ ð ɑ
ðɛ́vr̀ðɔ̀	ð ɛ v ɹ ð ɒ
ðɛ́vŕðɔ́	ð ɛ v ɹ ð ɒ
ðɛ́və̀lɛ̀ðà	ð ɛ v ə l ɛ ð ɑ
ðɛ́və̀lɛ̀ðɔ̀	ð ɛ v ə l ɛ ð ɒ
ðɛ́və̀lɛ̀ðɔ́	ð ɛ v ə l ɛ ð ɒ
ðɛ́və́lɛ́ðá	ð ɛ v ə l ɛ ð ɑ
ðɛ́vɛ́lɛ́ðá	ð ɛ v ɛ l ɛ ð ɑ
ðɛ́ðà	ð ɛ ð ɑ
ðɛ́ŋàŋà	ð ɛ ŋ ɑ ŋ ɑ
ðɛ́ŋáŋá	ð ɛ ŋ ɑ ŋ ɑ
ðɛ́ŋìa	ð ɛ ŋ i ɑ
ðɛ́ŋî	ð ɛ ŋ i
ðɛ́ŋîɾà	ð ɛ ŋ i ɾ ɑ
ðɛ́ŋɛ́n	ð ɛ ŋ ɛ n
ðɛ́ŋɛ́ná	ð ɛ ŋ ɛ n ɑ
ðɛ́ɲó	ð ɛ ɲ ow
ðɛ́ɲú	ð ɛ ɲ ʉ
ðɛ́ɽðà	ð ɛ ɹ ð ɑ
ðɛ́ɽðá	ð ɛ ɹ ð ɑ
ðɛ̂	ð ɛ
ðɛ̂j	ð ɛ j
ðɛ̂vlɛ̀ðɔ́	ð ɛ v l ɛ ð ɒ
ðɛ̌və́lɛ̂ðà	ð ɛ v ə l ɛ ð ɑ
ðɜ̀ríbì	ð ɐ ɹ i b i
ðɜ̀ríbɔ̀	ð ɐ ɹ i b ɒ
ðɜ́rìbì	ð ɐ ɹ i b i
ðɜ́rìbǐ	ð ɐ ɹ i b i
ðɜ́rîbì	ð ɐ ɹ i b i
ðɜ́ɽìbì	ð ɐ ɹ i b i
ðɜ́ɽí	ð ɐ ɹ i
ðɾav	ð ɾ ɑ v
ðɾàvɛ́	ð ɾ ɑ v ɛ
ðɾùvɛ́	ð ɾ ʉ v ɛ
ðɾɔ̀	ð ɾ ɒ
ðɾɔ́	ð ɾ ɒ
ðɾɔ́ðà	ð ɾ ɒ ð ɑ
ðɾɔ́ðǎ	ð ɾ ɒ ð ɑ
ðʊ̀dʊ̀	ð ʊ d ʊ
ðʊ́rʊ̀ŋɔ̀	ð ʊ ɹ ʊ ŋ ɒ
ðʊ́vɛ́	ð ʊ v ɛ
ð̀cò	ð tʃ ow
ð̀cùlɔ̀	ð tʃ ʉ l ɒ
ð̀cə̀lò	ð tʃ ə l ow
ð̀ráv	ð ɹ ɑ v
ð̀ə̀gàrɔ̀ðɛ́	ð ə ɡ ɑ ɹ ɒ ð ɛ
ð̀ɾə̀vɛ́	ð ɾ ə v ɛ
ð́ár	ð ɑ ɹ
ð́ídɔ̀t̪ɔ̀	ð i d ɒ t ɒ
ð́ídɔ̀t̪ɔ́	ð i d ɒ t ɒ
ð́r	ð ɹ
ŋ	ŋ
ŋa	ŋ ɑ
ŋamaɽaɾe	ŋ ɑ m ɑ ɹ ɑ ɾ ɛ
ŋamɽaɾɛ	ŋ ɑ m ɹ ɑ ɾ ɛ
ŋamɽárɛ̀	ŋ ɑ m ɹ ɑ ɹ ɛ
ŋawuðɛ	ŋ ɑ w ʉ ð ɛ
ŋà	ŋ ɑ
ŋàǎ	ŋ ɑ ɑ
ŋàcà	ŋ ɑ tʃ ɑ
ŋàcá	ŋ ɑ tʃ ɑ
ŋàcì	ŋ ɑ tʃ i
ŋàcí	ŋ ɑ tʃ i
ŋàcílì	ŋ ɑ tʃ i l i
ŋàcílí	ŋ ɑ tʃ i l i
ŋàcíl̀	ŋ ɑ tʃ i l
ŋàdàn	ŋ ɑ d ɑ n
ŋàí	ŋ ɑ i
ŋàíblàcɔ̀	ŋ ɑ i b l ɑ tʃ ɒ
ŋàjɛ́ðà	ŋ ɑ j ɛ ð ɑ
ŋàlóŋ	ŋ ɑ l ow ŋ
ŋàmàð	ŋ ɑ m ɑ ð
ŋàmánú	ŋ ɑ m ɑ n ʉ
ŋàmáð	ŋ ɑ m ɑ ð
ŋàmbòɽó	ŋ ɑ m b ow ɹ ow
ŋàmìɲí	ŋ ɑ m i ɲ i
ŋàmt̪ɛ̀ɾɛ̀	ŋ ɑ m t ɛ ɾ ɛ
ŋàmt̪ɛ̀ɾɛ́	ŋ ɑ m t ɛ ɾ ɛ
ŋàmɔ̀rðápríɲâ	ŋ ɑ m ɒ ɹ ð ɑ p ɹ i ɲ ɑ
ŋàmɔ̀rðɔ́	ŋ ɑ m ɒ ɹ ð ɒ
ŋàmə́ɲàt̪ɛ̀	ŋ ɑ m ə ɲ ɑ t ɛ
ŋàmɛ́ðɛ̀nɛ́	ŋ ɑ m ɛ ð ɛ n ɛ
ŋàmɲí	ŋ ɑ m ɲ i
ŋàmɽàrè	ŋ ɑ m ɹ ɑ ɹ ɛ
ŋàmɽàrɛ̀	ŋ ɑ m ɹ ɑ ɹ ɛ
ŋàmɽàɽè	ŋ ɑ m ɹ ɑ ɹ ɛ
ŋàmɽàɾɛ̀	ŋ ɑ m ɹ ɑ ɾ ɛ
ŋàmɽàɾɛ̌	ŋ ɑ m ɹ ɑ ɾ ɛ
ŋàmɽárè	ŋ ɑ m ɹ ɑ ɹ ɛ
ŋàmɽárɛ̀	ŋ ɑ m ɹ ɑ ɹ ɛ
ŋàmɽárɛ́	ŋ ɑ m ɹ ɑ ɹ ɛ
ŋàmɽáɾɛ́	ŋ ɑ m ɹ ɑ ɾ ɛ
ŋàn	ŋ ɑ n
ŋànt̪ɔ́	ŋ ɑ n t ɒ
ŋàré	ŋ ɑ ɹ ɛ
ŋàrvbɛ̀cɛ̀́	ŋ ɑ ɹ v b ɛ tʃ ɛ
ŋàrðá	ŋ ɑ ɹ ð ɑ
ŋàrɔ́	ŋ ɑ ɹ ɒ
ŋàrə̀m	ŋ ɑ ɹ ə m
ŋàrɛ̀mnɔ́	ŋ ɑ ɹ ɛ m n ɒ
ŋàŕlɛ̀ɲì	ŋ ɑ ɹ l ɛ ɲ i
ŋàtá	ŋ ɑ t ɑ
ŋàtìðá	ŋ ɑ t i ð ɑ
ŋàtɛ́və́lɛ̀ðà	ŋ ɑ t ɛ v ə l ɛ ð ɑ
ŋàtɛ́və́lɛ̀ðàŕ	ŋ ɑ t ɛ v ə l ɛ ð ɑ ɹ
ŋàù	ŋ ɑ ʉ
ŋàv	ŋ ɑ v
ŋàvàrà	ŋ ɑ v ɑ ɹ ɑ
ŋàvə̀lɛ̀ðɛ̀	ŋ ɑ v ə l ɛ ð ɛ
ŋàvə́lɛ̀ðɛ̀	ŋ ɑ v ə l ɛ ð ɛ
ŋàvə́lɛ̂ðɛ̀	ŋ ɑ v ə l ɛ ð ɛ
ŋàvə́lɛ̂ðɛ̌	ŋ ɑ v ə l ɛ ð ɛ
ŋàvɛ̀	ŋ ɑ v ɛ
ŋàðàŋnánú	ŋ ɑ ð ɑ ŋ n ɑ n ʉ
ŋàðrɛ̀ḿnɔ́mnà	ŋ ɑ ð ɹ ɛ m n ɒ m n ɑ
ŋàðə̀ŋnánó	ŋ ɑ ð ə ŋ n ɑ n ow
ŋàðə̀ŋŋàðìŋnɔ́	ŋ ɑ ð ə ŋ ŋ ɑ ð i ŋ n ɒ
ŋàðɛ̀	ŋ ɑ ð ɛ
ŋàðɛ̀ŋðànánú	ŋ ɑ ð ɛ ŋ ð ɑ n ɑ n ʉ
ŋàðɛ́	ŋ ɑ ð ɛ
ŋàðɜ̀ŋnɛ̀	ŋ ɑ ð ɐ ŋ n ɛ
ŋàŋá	ŋ ɑ ŋ ɑ
ŋàŋcíŋì	ŋ ɑ ŋ tʃ i ŋ i
ŋàŋcî	ŋ ɑ ŋ tʃ i
ŋàŋí	ŋ ɑ ŋ i
ŋàŋíɲár	ŋ ɑ ŋ i ɲ ɑ ɹ
ŋàŋt̪ɔ́l	ŋ ɑ ŋ t ɒ l
ŋàŋvə́lɛ̂ðɛ̀	ŋ ɑ ŋ v ə l ɛ ð ɛ
ŋàŋɔ̀nɔ́l	ŋ ɑ ŋ ɒ n ɒ l
ŋàŋɔ́	ŋ ɑ ŋ ɒ
ŋàɲà	ŋ ɑ ɲ ɑ
ŋàɽà	ŋ ɑ ɹ ɑ
ŋàɽàŋàt̪ìnò	ŋ ɑ ɹ ɑ ŋ ɑ t i n ow
ŋàɽàŋrà	ŋ ɑ ɹ ɑ ŋ ɹ ɑ
ŋàɽǎ	ŋ ɑ ɹ ɑ
ŋàɽə̀ŋàt̪ìnò	ŋ ɑ ɹ ə ŋ ɑ t i n ow
ŋàɽə̀ŋàt̪ìnó	ŋ ɑ ɹ ə ŋ ɑ t i n ow
ŋàɾà	ŋ ɑ ɾ ɑ
ŋàɾánɛ̀	ŋ ɑ ɾ ɑ n ɛ
ŋàɾánɛ́	ŋ ɑ ɾ ɑ n ɛ
ŋàɾân	ŋ ɑ ɾ ɑ n
ŋàɾó	ŋ ɑ ɾ ow
ŋàɾɛ́	ŋ ɑ ɾ ɛ
ŋá	ŋ ɑ
ŋábrà	ŋ ɑ b ɹ ɑ
ŋábrì	ŋ ɑ b ɹ i
ŋábrt̪à	ŋ ɑ b ɹ t ɑ
ŋábr̀t̪ɛ̀	ŋ ɑ b ɹ t ɛ
ŋábùt̪à	ŋ ɑ b ʉ t ɑ
ŋábùt̪ɛ̀	ŋ ɑ b ʉ t ɛ
ŋábùðà	ŋ ɑ b ʉ ð ɑ
ŋábùðì	ŋ ɑ b ʉ ð i
ŋácà	ŋ ɑ tʃ ɑ
ŋácì	ŋ ɑ tʃ i
ŋácí	ŋ ɑ tʃ i
ŋácílè	ŋ ɑ tʃ i l ɛ
ŋácílí	ŋ ɑ tʃ i l i
ŋácílǐ	ŋ ɑ tʃ i l i
ŋácɔ̀	ŋ ɑ tʃ ɒ
ŋácɔ́	ŋ ɑ tʃ ɒ
ŋádàn	ŋ ɑ d ɑ n
ŋádɔ̀ŋnɛ̀	ŋ ɑ d ɒ ŋ n ɛ
ŋád̪ùmɔ̀	ŋ ɑ d ʉ m ɒ
ŋái	ŋ ɑ i
ŋáì	ŋ ɑ i
ŋáǐ	ŋ ɑ i
ŋájà	ŋ ɑ j ɑ
ŋájì	ŋ ɑ j i
ŋájɛ̀	ŋ ɑ j ɛ
ŋálbɛ̀t̪ɔ̀	ŋ ɑ l b ɛ t ɒ
ŋálòŋ	ŋ ɑ l ow ŋ
ŋáló	ŋ ɑ l ow
ŋálóŋ	ŋ ɑ l ow ŋ
ŋálù	ŋ ɑ l ʉ
ŋálvə́lɛ̀ðɛ̀	ŋ ɑ l v ə l ɛ ð ɛ
ŋálə̀ŋà	ŋ ɑ l ə ŋ ɑ
ŋálə̀ŋɛ̀	ŋ ɑ l ə ŋ ɛ
ŋám	ŋ ɑ m
ŋámà	ŋ ɑ m ɑ
ŋámàcà	ŋ ɑ m ɑ tʃ ɑ
ŋámàcì	ŋ ɑ m ɑ tʃ i
ŋámàcìjìðì	ŋ ɑ m ɑ tʃ i j i ð i
ŋámánú	ŋ ɑ m ɑ n ʉ
ŋámáðɛ̀	ŋ ɑ m ɑ ð ɛ
ŋámiɲì	ŋ ɑ m i ɲ i
ŋámìɲà	ŋ ɑ m i ɲ ɑ
ŋámìɲì	ŋ ɑ m i ɲ i
ŋámìɲí	ŋ ɑ m i ɲ i
ŋámíɲì	ŋ ɑ m i ɲ i
ŋámíɲ́ɛŋnɔ̀rnɔ̀	ŋ ɑ m i ɲ ɛ ŋ n ɒ ɹ n ɒ
ŋámɽàrè	ŋ ɑ m ɹ ɑ ɹ ɛ
ŋámɽàré	ŋ ɑ m ɹ ɑ ɹ ɛ
ŋámɽàrě	ŋ ɑ m ɹ ɑ ɹ ɛ
ŋámɽàrɛ̀	ŋ ɑ m ɹ ɑ ɹ ɛ
ŋámɽàɾɛ̀	ŋ ɑ m ɹ ɑ ɾ ɛ
ŋámɽàɾɛ́	ŋ ɑ m ɹ ɑ ɾ ɛ
ŋámɽáré	ŋ ɑ m ɹ ɑ ɹ ɛ
ŋámɽárɛ̀	ŋ ɑ m ɹ ɑ ɹ ɛ
ŋámɽárɛ́	ŋ ɑ m ɹ ɑ ɹ ɛ
ŋámɽáɾè	ŋ ɑ m ɹ ɑ ɾ ɛ
ŋámɽáɾé	ŋ ɑ m ɹ ɑ ɾ ɛ
ŋámɽáɾě	ŋ ɑ m ɹ ɑ ɾ ɛ
ŋámɽáɾɛ̀	ŋ ɑ m ɹ ɑ ɾ ɛ
ŋámɽáɾɛ́	ŋ ɑ m ɹ ɑ ɾ ɛ
ŋám̀ɲí	ŋ ɑ m ɲ i
ŋán	ŋ ɑ n
ŋánó	ŋ ɑ n ow
ŋánt̪ɛ̀	ŋ ɑ n t ɛ
ŋánɔ̀nà	ŋ ɑ n ɒ n ɑ
ŋánɔ́nà	ŋ ɑ n ɒ n ɑ
ŋánɔ̂nà	ŋ ɑ n ɒ n ɑ
ŋánɔ̂nt̪ɔ̀t̪á	ŋ ɑ n ɒ n t ɒ t ɑ
ŋánɛ̀	ŋ ɑ n ɛ
ŋáò	ŋ ɑ ow
ŋáó	ŋ ɑ ow
ŋápà	ŋ ɑ p ɑ
ŋápɛ̀	ŋ ɑ p ɛ
ŋár	ŋ ɑ ɹ
ŋárà	ŋ ɑ ɹ ɑ
ŋárámnà	ŋ ɑ ɹ ɑ m n ɑ
ŋárdɔ̀cɔ̀	ŋ ɑ ɹ d ɒ tʃ ɒ
ŋárdɛ̀cà	ŋ ɑ ɹ d ɛ tʃ ɑ
ŋárdɛ̀cí	ŋ ɑ ɹ d ɛ tʃ i
ŋárdɛ̀cɔ̀	ŋ ɑ ɹ d ɛ tʃ ɒ
ŋárdɛ̀cɔ̀t̪ɔ̀lɲánú	ŋ ɑ ɹ d ɛ tʃ ɒ t ɒ l ɲ ɑ n ʉ
ŋárì	ŋ ɑ ɹ i
ŋárlàndè	ŋ ɑ ɹ l ɑ n d ɛ
ŋárlàɲí	ŋ ɑ ɹ l ɑ ɲ i
ŋárlɔ̂ɲɔ̀	ŋ ɑ ɹ l ɒ ɲ ɒ
ŋárlə̀ɲɔ̀	ŋ ɑ ɹ l ə ɲ ɒ
ŋárlɛ̀ŋí	ŋ ɑ ɹ l ɛ ŋ i
ŋárlɛ̀ɲì	ŋ ɑ ɹ l ɛ ɲ i
ŋárlɛ́ŋì	ŋ ɑ ɹ l ɛ ŋ i
ŋárlɛ́ɲì	ŋ ɑ ɹ l ɛ ɲ i
ŋáró	ŋ ɑ ɹ ow
ŋárô	ŋ ɑ ɹ ow
ŋártá	ŋ ɑ ɹ t ɑ
ŋárt̪á	ŋ ɑ ɹ t ɑ
ŋárt̪ɛ̀	ŋ ɑ ɹ t ɛ
ŋárt̪ɛ̌	ŋ ɑ ɹ t ɛ
ŋárðà	ŋ ɑ ɹ ð ɑ
ŋárðó	ŋ ɑ ɹ ð ow
ŋárðɔ́	ŋ ɑ ɹ ð ɒ
ŋárðɛ̀	ŋ ɑ ɹ ð ɛ
ŋárðɛ̀ŋnɛ̀	ŋ ɑ ɹ ð ɛ ŋ n ɛ
ŋárðɛ̀ŋnɛ̌	ŋ ɑ ɹ ð ɛ ŋ n ɛ
ŋárðɜ̀ŋnɛ̀	ŋ ɑ ɹ ð ɐ ŋ n ɛ
ŋárɔ̀	ŋ ɑ ɹ ɒ
ŋárɔ́	ŋ ɑ ɹ ɒ
ŋárə̀ŋàt̪ǎ	ŋ ɑ ɹ ə ŋ ɑ t ɑ
ŋárɛ̀mnà	ŋ ɑ ɹ ɛ m n ɑ
ŋátíðú	ŋ ɑ t i ð ʉ
ŋátɔ́	ŋ ɑ t ɒ
ŋátɛ́	ŋ ɑ t ɛ
ŋátɛ́və́lɛ̀ðɛ̀	ŋ ɑ t ɛ v ə l ɛ ð ɛ
ŋátɛ́və́lɛ̀ðɛ̀r	ŋ ɑ t ɛ v ə l ɛ ð ɛ ɹ
ŋátɛ́və́lɛ̂ðɛ̀	ŋ ɑ t ɛ v ə l ɛ ð ɛ
ŋátɛ́və́lɛ̂ðɛ̀r	ŋ ɑ t ɛ v ə l ɛ ð ɛ ɹ
ŋávdàcɔ̀	ŋ ɑ v d ɑ tʃ ɒ
ŋávd̪àcɔ̀	ŋ ɑ v d ɑ tʃ ɒ
ŋávd̪í	ŋ ɑ v d i
ŋávd̪ɔ̀	ŋ ɑ v d ɒ
ŋávè	ŋ ɑ v ɛ
ŋávìðàcà	ŋ ɑ v i ð ɑ tʃ ɑ
ŋávìðàcì	ŋ ɑ v i ð ɑ tʃ i
ŋávlɛ̀ðɛ̀	ŋ ɑ v l ɛ ð ɛ
ŋávə̀lɛ̀ðɔ́	ŋ ɑ v ə l ɛ ð ɒ
ŋávə̀lɛ̀ðɛ̀	ŋ ɑ v ə l ɛ ð ɛ
ŋávə́lɛ̀ðà	ŋ ɑ v ə l ɛ ð ɑ
ŋávə́lɛ̀ðɛ̀	ŋ ɑ v ə l ɛ ð ɛ
ŋávɛ̀	ŋ ɑ v ɛ
ŋávɛ́	ŋ ɑ v ɛ
ŋávɛ̌	ŋ ɑ v ɛ
ŋáw	ŋ ɑ w
ŋáwà	ŋ ɑ w ɑ
ŋáwì	ŋ ɑ w i
ŋáð	ŋ ɑ ð
ŋáðə̀ŋnánó	ŋ ɑ ð ə ŋ n ɑ n ow
ŋáðə̀ŋnɔ̀	ŋ ɑ ð ə ŋ n ɒ
ŋáðə̀ŋnɛ̀	ŋ ɑ ð ə ŋ n ɛ
ŋáðə́ŋnɛ̀	ŋ ɑ ð ə ŋ n ɛ
ŋáðɜ̀ŋnánó	ŋ ɑ ð ɐ ŋ n ɑ n ow
ŋáðɜ̀ŋnɛ̀	ŋ ɑ ð ɐ ŋ n ɛ
ŋáð́ðə̀ŋnánó	ŋ ɑ ð ð ə ŋ n ɑ n ow
ŋáŋà	ŋ ɑ ŋ ɑ
ŋáŋàl	ŋ ɑ ŋ ɑ l
ŋáŋâl	ŋ ɑ ŋ ɑ l
ŋáŋèŋí	ŋ ɑ ŋ ɛ ŋ i
ŋáŋì	ŋ ɑ ŋ i
ŋáŋî	ŋ ɑ ŋ i
ŋáŋt̪à	ŋ ɑ ŋ t ɑ
ŋáŋt̪á	ŋ ɑ ŋ t ɑ
ŋáŋɔ́	ŋ ɑ ŋ ɒ
ŋáɽà	ŋ ɑ ɹ ɑ
ŋáɽá	ŋ ɑ ɹ ɑ
ŋáɽì	ŋ ɑ ɹ i
ŋáɽìðà	ŋ ɑ ɹ i ð ɑ
ŋáɽìðì	ŋ ɑ ɹ i ð i
ŋáɽìɲɔ́	ŋ ɑ ɹ i ɲ ɒ
ŋáɽə̀ŋàt̪à	ŋ ɑ ɹ ə ŋ ɑ t ɑ
ŋáɽə̀ŋàt̪ɛ̀	ŋ ɑ ɹ ə ŋ ɑ t ɛ
ŋáɽə́ŋàt̪à	ŋ ɑ ɹ ə ŋ ɑ t ɑ
ŋáɽə́ŋàt̪ǎ	ŋ ɑ ɹ ə ŋ ɑ t ɑ
ŋâi	ŋ ɑ i
ŋâí	ŋ ɑ i
ŋâjɔ́	ŋ ɑ j ɒ
ŋâjɛ̀ðò	ŋ ɑ j ɛ ð ow
ŋâjɛ̀ðó	ŋ ɑ j ɛ ð ow
ŋâl	ŋ ɑ l
ŋâmɽàrɛ̀	ŋ ɑ m ɹ ɑ ɹ ɛ
ŋâó	ŋ ɑ ow
ŋârlɛ̀ɲí	ŋ ɑ ɹ l ɛ ɲ i
ŋârt̪ɛ̀	ŋ ɑ ɹ t ɛ
ŋâvlɛ̀ðɛ̀	ŋ ɑ v l ɛ ð ɛ
ŋâvə̀lɛ̀ðà	ŋ ɑ v ə l ɛ ð ɑ
ŋâvə̀lɛ̀ðɛ̌	ŋ ɑ v ə l ɛ ð ɛ
ŋâŋ	ŋ ɑ ŋ
ŋâŋ̌	ŋ ɑ ŋ
ŋǎ	ŋ ɑ
ŋǎi	ŋ ɑ i
ŋǎjà	ŋ ɑ j ɑ
ŋǎl̀və̀lɛ̀ðɛ̀	ŋ ɑ l v ə l ɛ ð ɛ
ŋǎn	ŋ ɑ n
ŋǎw	ŋ ɑ w
ŋǎð	ŋ ɑ ð
ŋdúɛ̀t̪ɛ̌	ŋ d ʉ ɛ t ɛ
ŋdɔ̀bɔ̀gɛ̀	ŋ d ɒ b ɒ ɡ ɛ
ŋdə́màt̪è	ŋ d ə m ɑ t ɛ
ŋe	ŋ ɛ
ŋeìðèní	ŋ ɛ i ð ɛ n i
ŋeðeno	ŋ ɛ ð ɛ n ow
ŋè	ŋ ɛ
ŋèdé	ŋ ɛ d ɛ
ŋèdéɲá	ŋ ɛ d ɛ ɲ ɑ
ŋèdéɲâ	ŋ ɛ d ɛ ɲ ɑ
ŋèrɛ̀mnà	ŋ ɛ ɹ ɛ m n ɑ
ŋèðèní	ŋ ɛ ð ɛ n i
ŋèðènɔ́	ŋ ɛ ð ɛ n ɒ
ŋèðìní	ŋ ɛ ð i n i
ŋèðìŋìní	ŋ ɛ ð i ŋ i n i
ŋèðə̀ní	ŋ ɛ ð ə n i
ŋèð̀ní	ŋ ɛ ð n i
ŋénà	ŋ ɛ n ɑ
ŋénɛ̀	ŋ ɛ n ɛ
ŋéðénɔ̀	ŋ ɛ ð ɛ n ɒ
ŋéɲár	ŋ ɛ ɲ ɑ ɹ
ŋéɲɛ́	ŋ ɛ ɲ ɛ
ŋê	ŋ ɛ
ŋêlo	ŋ ɛ l ow
ŋêvə̀lɛ̀ðà	ŋ ɛ v ə l ɛ ð ɑ
ŋěn	ŋ ɛ n
ŋgaírdɔ̀cɔ̌	ŋ ɡ ɑ i ɹ d ɒ tʃ ɒ
ŋgajirdɔcɔ	ŋ ɡ ɑ j i ɹ d ɒ tʃ ɒ
ŋgà	ŋ ɡ ɑ
ŋgàcɛ̀cí	ŋ ɡ ɑ tʃ ɛ tʃ i
ŋgàdíjà	ŋ ɡ ɑ d i j ɑ
ŋgàjájât̪à	ŋ ɡ ɑ j ɑ j ɑ t ɑ
ŋgàjájât̪ǎ	ŋ ɡ ɑ j ɑ j ɑ t ɑ
ŋgàjjá	ŋ ɡ ɑ j j ɑ
ŋgàó	ŋ ɡ ɑ ow
ŋgàðə́nɔ̀nà	ŋ ɡ ɑ ð ə n ɒ n ɑ
ŋgàðə́nɔ̀ná	ŋ ɡ ɑ ð ə n ɒ n ɑ
ŋgàɽíɲà	ŋ ɡ ɑ ɹ i ɲ ɑ
ŋgàɽíɲǎ	ŋ ɡ ɑ ɹ i ɲ ɑ
ŋgàɾàt̪ɔ́	ŋ ɡ ɑ ɾ ɑ t ɒ
ŋgàɾcàcí	ŋ ɡ ɑ ɾ tʃ ɑ tʃ i
ŋgàɾcìðà	ŋ ɡ ɑ ɾ tʃ i ð ɑ
ŋgàɾcìðú	ŋ ɡ ɑ ɾ tʃ i ð ʉ
ŋgàɾcí	ŋ ɡ ɑ ɾ tʃ i
ŋgàɾìjí	ŋ ɡ ɑ ɾ i j i
ŋgàɾìðù	ŋ ɡ ɑ ɾ i ð ʉ
ŋgàɾìðú	ŋ ɡ ɑ ɾ i ð ʉ
ŋgàɾó	ŋ ɡ ɑ ɾ ow
ŋgá	ŋ ɡ ɑ
ŋgábrɔ̀cɔ̀	ŋ ɡ ɑ b ɹ ɒ tʃ ɒ
ŋgábə́ɽìnɔ̀	ŋ ɡ ɑ b ə ɹ i n ɒ
ŋgádíjɜ̀	ŋ ɡ ɑ d i j ɐ
ŋgádíjɜ́	ŋ ɡ ɑ d i j ɐ
ŋgádíjɜ̌	ŋ ɡ ɑ d i j ɐ
ŋgádínɔ̀	ŋ ɡ ɑ d i n ɒ
ŋgádínɔ̌	ŋ ɡ ɑ d i n ɒ
ŋgádɔ̀ŋnɔ̌	ŋ ɡ ɑ d ɒ ŋ n ɒ
ŋgádɔ́ŋɔ̀nɔ̀	ŋ ɡ ɑ d ɒ ŋ ɒ n ɒ
ŋgád̪úrò	ŋ ɡ ɑ d ʉ ɹ ow
ŋgágàɾìðú	ŋ ɡ ɑ ɡ ɑ ɾ i ð ʉ
ŋgágârà	ŋ ɡ ɑ ɡ ɑ ɹ ɑ
ŋgágéɲà	ŋ ɡ ɑ ɡ ɛ ɲ ɑ
ŋgágít̪ɔ̀	ŋ ɡ ɑ ɡ i t ɒ
ŋgágə̀cìðú	ŋ ɡ ɑ ɡ ə tʃ i ð ʉ
ŋgáídɔ̀t̪ɔ̀	ŋ ɡ ɑ i d ɒ t ɒ
ŋgáíjà	ŋ ɡ ɑ i j ɑ
ŋgájà	ŋ ɡ ɑ j ɑ
ŋgájá	ŋ ɡ ɑ j ɑ
ŋgájájât̪à	ŋ ɡ ɑ j ɑ j ɑ t ɑ
ŋgájǎ	ŋ ɡ ɑ j ɑ
ŋgájéðà	ŋ ɡ ɑ j ɛ ð ɑ
ŋgájíð́ìnɔ̀	ŋ ɡ ɑ j i ð i n ɒ
ŋgákàɾcìðàðú	ŋ ɡ ɑ k ɑ ɾ tʃ i ð ɑ ð ʉ
ŋgákàɾcìðú	ŋ ɡ ɑ k ɑ ɾ tʃ i ð ʉ
ŋgákáɾcíðà	ŋ ɡ ɑ k ɑ ɾ tʃ i ð ɑ
ŋgákl̀càcí	ŋ ɡ ɑ k l tʃ ɑ tʃ i
ŋgákl̀càt̪ɔ́	ŋ ɡ ɑ k l tʃ ɑ t ɒ
ŋgákl̀cí	ŋ ɡ ɑ k l tʃ i
ŋgákĺcà	ŋ ɡ ɑ k l tʃ ɑ
ŋgákĺcàcà	ŋ ɡ ɑ k l tʃ ɑ tʃ ɑ
ŋgákĺcàtà	ŋ ɡ ɑ k l tʃ ɑ t ɑ
ŋgákĺcàt̪à	ŋ ɡ ɑ k l tʃ ɑ t ɑ
ŋgákĺcìtɔ̀	ŋ ɡ ɑ k l tʃ i t ɒ
ŋgálàpìjí	ŋ ɡ ɑ l ɑ p i j i
ŋgálàpìjɔ̀	ŋ ɡ ɑ l ɑ p i j ɒ
ŋgálàpìnjí	ŋ ɡ ɑ l ɑ p i n j i
ŋgálácà	ŋ ɡ ɑ l ɑ tʃ ɑ
ŋgálácǎ	ŋ ɡ ɑ l ɑ tʃ ɑ
ŋgálvə̀lɛ̀ðà	ŋ ɡ ɑ l v ə l ɛ ð ɑ
ŋgálvə̀lɛ̀ðǎ	ŋ ɡ ɑ l v ə l ɛ ð ɑ
ŋgálvə́lɛ̂ðà	ŋ ɡ ɑ l v ə l ɛ ð ɑ
ŋgálvə́lɛ̂ðàŕ	ŋ ɡ ɑ l v ə l ɛ ð ɑ ɹ
ŋgálə́ŕvə́lɛ̂ðǎŕ	ŋ ɡ ɑ l ə ɹ v ə l ɛ ð ɑ ɹ
ŋgál̀və̀lɛ̀ðà	ŋ ɡ ɑ l v ə l ɛ ð ɑ
ŋgámút̪ɔ̀nɔ̀	ŋ ɡ ɑ m ʉ t ɒ n ɒ
ŋgánɔ̀nà	ŋ ɡ ɑ n ɒ n ɑ
ŋgánɔ́na	ŋ ɡ ɑ n ɒ n ɑ
ŋgánɔ́nà	ŋ ɡ ɑ n ɒ n ɑ
ŋgánɔ̂nà	ŋ ɡ ɑ n ɒ n ɑ
ŋgánɔ̂nǎ	ŋ ɡ ɑ n ɒ n ɑ
ŋgápà	ŋ ɡ ɑ p ɑ
ŋgápát̪ɛ̀	ŋ ɡ ɑ p ɑ t ɛ
ŋgápìjìnɔ	ŋ ɡ ɑ p i j i n ɒ
ŋgápìnjí	ŋ ɡ ɑ p i n j i
ŋgápìnɔ̀	ŋ ɡ ɑ p i n ɒ
ŋgápínìjɔ̀	ŋ ɡ ɑ p i n i j ɒ
ŋgápínɔ̀	ŋ ɡ ɑ p i n ɒ
ŋgápít̪ɔ̀	ŋ ɡ ɑ p i t ɒ
ŋgápít̪ɔ̀ɔ̌	ŋ ɡ ɑ p i t ɒ ɒ
ŋgápít̪ɛ̀	ŋ ɡ ɑ p i t ɛ
ŋgápíðàðì	ŋ ɡ ɑ p i ð ɑ ð i
ŋgápíðìt̪ɔ̀	ŋ ɡ ɑ p i ð i t ɒ
ŋgápíðɔ̀	ŋ ɡ ɑ p i ð ɒ
ŋgápíðɔ̀t̪ɔ̀	ŋ ɡ ɑ p i ð ɒ t ɒ
ŋgápíðɔ̀ɔ̌	ŋ ɡ ɑ p i ð ɒ ɒ
ŋgápɔ̀	ŋ ɡ ɑ p ɒ
ŋgápɔ́t̪ìðɔ̀	ŋ ɡ ɑ p ɒ t i ð ɒ
ŋgápɔ́t̪ɔ̀	ŋ ɡ ɑ p ɒ t ɒ
ŋgápʊ́lɔ̀	ŋ ɡ ɑ p ʊ l ɒ
ŋgárà	ŋ ɡ ɑ ɹ ɑ
ŋgárcà	ŋ ɡ ɑ ɹ tʃ ɑ
ŋgárcì	ŋ ɡ ɑ ɹ tʃ i
ŋgárdɔ̀cɔ̀t̪ɔɲ	ŋ ɡ ɑ ɹ d ɒ tʃ ɒ t ɒ ɲ
ŋgárdɔ̀ŋðà	ŋ ɡ ɑ ɹ d ɒ ŋ ð ɑ
ŋgárdɛ̀cà	ŋ ɡ ɑ ɹ d ɛ tʃ ɑ
ŋgár̀lànd̪ɔ́	ŋ ɡ ɑ ɹ l ɑ n d ɒ
ŋgár̀lɛ̀nd̪ìjí	ŋ ɡ ɑ ɹ l ɛ n d i j i
ŋgár̀lɜ̀nd̪ìt̪ɔ́	ŋ ɡ ɑ ɹ l ɐ n d i t ɒ
ŋgáŕlànd̪à	ŋ ɡ ɑ ɹ l ɑ n d ɑ
ŋgáŕlɜ̀nd̪ìjɔ̀	ŋ ɡ ɑ ɹ l ɐ n d i j ɒ
ŋgáŕlɜ̀nd̪ìt̪ɔ̀	ŋ ɡ ɑ ɹ l ɐ n d i t ɒ
ŋgáŕlɜ̀nd̪ìt̪ɔ́	ŋ ɡ ɑ ɹ l ɐ n d i t ɒ
ŋgátɛ́və́lɛ̂ðà	ŋ ɡ ɑ t ɛ v ə l ɛ ð ɑ
ŋgátɛ́və́lɛ̂ðàŕ	ŋ ɡ ɑ t ɛ v ə l ɛ ð ɑ ɹ
ŋgát̪íðɔ̀	ŋ ɡ ɑ t i ð ɒ
ŋgát̪ə̀và	ŋ ɡ ɑ t ə v ɑ
ŋgát̪ə̀vɔ́	ŋ ɡ ɑ t ə v ɒ
ŋgát̪ə́và	ŋ ɡ ɑ t ə v ɑ
ŋgávə̀lɛ̀ðà	ŋ ɡ ɑ v ə l ɛ ð ɑ
ŋgávə̀lɛ̀ðɔ́	ŋ ɡ ɑ v ə l ɛ ð ɒ
ŋgávə́lɛ̀ðà	ŋ ɡ ɑ v ə l ɛ ð ɑ
ŋgáŋ	ŋ ɡ ɑ ŋ
ŋgáŋà	ŋ ɡ ɑ ŋ ɑ
ŋgáŋàtìðìjí	ŋ ɡ ɑ ŋ ɑ t i ð i j i
ŋgáŋàt̪ìt̪ɔ́	ŋ ɡ ɑ ŋ ɑ t i t ɒ
ŋgáŋàt̪ɔ́	ŋ ɡ ɑ ŋ ɑ t ɒ
ŋgáŋácà	ŋ ɡ ɑ ŋ ɑ tʃ ɑ
ŋgáŋátìjɔ̀	ŋ ɡ ɑ ŋ ɑ t i j ɒ
ŋgáŋátìðìjɔ̀	ŋ ɡ ɑ ŋ ɑ t i ð i j ɒ
ŋgáŋát̪à	ŋ ɡ ɑ ŋ ɑ t ɑ
ŋgáŋát̪ìt̪ɔ̀	ŋ ɡ ɑ ŋ ɑ t i t ɒ
ŋgáŋát̪ìðìt̪ɔ̀	ŋ ɡ ɑ ŋ ɑ t i ð i t ɒ
ŋgáŋâ	ŋ ɡ ɑ ŋ ɑ
ŋgáŋâl	ŋ ɡ ɑ ŋ ɑ l
ŋgáŋâvə̀lɛ̀ðà	ŋ ɡ ɑ ŋ ɑ v ə l ɛ ð ɑ
ŋgáŋâŋcɔ̀	ŋ ɡ ɑ ŋ ɑ ŋ tʃ ɒ
ŋgáŋâŋcɔ̌	ŋ ɡ ɑ ŋ ɑ ŋ tʃ ɒ
ŋgáŋâŋìcɔ̌	ŋ ɡ ɑ ŋ ɑ ŋ i tʃ ɒ
ŋgáŋêvə̀lɛ̀ðà	ŋ ɡ ɑ ŋ ɛ v ə l ɛ ð ɑ
ŋgáŋì	ŋ ɡ ɑ ŋ i
ŋgáŋî	ŋ ɡ ɑ ŋ i
ŋgáŋîí	ŋ ɡ ɑ ŋ i i
ŋgáŋvə́lɛ̂ðà	ŋ ɡ ɑ ŋ v ə l ɛ ð ɑ
ŋgáŋɔ́nà	ŋ ɡ ɑ ŋ ɒ n ɑ
ŋgáŋɔ̂ɽɟɛ̀cà	ŋ ɡ ɑ ŋ ɒ ɹ dʒ ɛ tʃ ɑ
ŋgáŋɔ̂ɽɟɛ̀cí	ŋ ɡ ɑ ŋ ɒ ɹ dʒ ɛ tʃ i
ŋgáɽə̀ŋàt̪á	ŋ ɡ ɑ ɹ ə ŋ ɑ t ɑ
ŋgáɽə̀ŋàt̪ǎ	ŋ ɡ ɑ ɹ ə ŋ ɑ t ɑ
ŋgáɽɟɛ̀cà	ŋ ɡ ɑ ɹ dʒ ɛ tʃ ɑ
ŋgáɾà	ŋ ɡ ɑ ɾ ɑ
ŋgáɾǎ	ŋ ɡ ɑ ɾ ɑ
ŋgáɾŋít̪ɔ̀	ŋ ɡ ɑ ɾ ŋ i t ɒ
ŋgáɾŋɔ́t̪ɔ̀	ŋ ɡ ɑ ɾ ŋ ɒ t ɒ
ŋgâpìnɔ́	ŋ ɡ ɑ p i n ɒ
ŋgâpìt̪ìt̪ɔ́	ŋ ɡ ɑ p i t i t ɒ
ŋgâpìt̪ɔ́	ŋ ɡ ɑ p i t ɒ
ŋgâpìðàðú	ŋ ɡ ɑ p i ð ɑ ð ʉ
ŋgâpìðìt̪ɔ́	ŋ ɡ ɑ p i ð i t ɒ
ŋgâpìðú	ŋ ɡ ɑ p i ð ʉ
ŋgâpìðɔ̀t̪ɔ́	ŋ ɡ ɑ p i ð ɒ t ɒ
ŋgâpɔ̀t̪ìðú	ŋ ɡ ɑ p ɒ t i ð ʉ
ŋgâpɔ̀t̪ɔ́	ŋ ɡ ɑ p ɒ t ɒ
ŋgâpɔ́	ŋ ɡ ɑ p ɒ
ŋgât̪ìðú	ŋ ɡ ɑ t i ð ʉ
ŋgâvə̀lɛ̀ðɔ́	ŋ ɡ ɑ v ə l ɛ ð ɒ
ŋgâɾùŋú	ŋ ɡ ɑ ɾ ʉ ŋ ʉ
ŋgâɾŋìt̪ɔ́	ŋ ɡ ɑ ɾ ŋ i t ɒ
ŋgâɾŋɔ̀t̪ɔ́	ŋ ɡ ɑ ɾ ŋ ɒ t ɒ
ŋgǎ	ŋ ɡ ɑ
ŋgǎdɔ̀ŋnɔ̌	ŋ ɡ ɑ d ɒ ŋ n ɒ
ŋgǎlvə́lɛ̂ðó	ŋ ɡ ɑ l v ə l ɛ ð ow
ŋgǎlvə́lɛ̂ðór	ŋ ɡ ɑ l v ə l ɛ ð ow ɹ
ŋgǎpít̪ìt̪ɔ̀	ŋ ɡ ɑ p i t i t ɒ
ŋgǎpíðɔ̀ðɔ̀	ŋ ɡ ɑ p i ð ɒ ð ɒ
ŋgǎpíðɔ̀ðɔ̀ɔ̌	ŋ ɡ ɑ p i ð ɒ ð ɒ ɒ
ŋgǎŋâvlɛ̀dɔ́	ŋ ɡ ɑ ŋ ɑ v l ɛ d ɒ
ŋgǎŋîvlɛ̀ðɔ̀	ŋ ɡ ɑ ŋ i v l ɛ ð ɒ
ŋgǎŋîvlɛ̀ðɔ́	ŋ ɡ ɑ ŋ i v l ɛ ð ɒ
ŋgǎŋvə́lɛ̂dɔ́	ŋ ɡ ɑ ŋ v ə l ɛ d ɒ
ŋgǎŋə́və́lɛ̂dɔ́	ŋ ɡ ɑ ŋ ə v ə l ɛ d ɒ
ŋgǎɾúŋɔ̀	ŋ ɡ ɑ ɾ ʉ ŋ ɒ
ŋgé	ŋ ɡ ɛ
ŋgévə́lɛ̀ðà	ŋ ɡ ɛ v ə l ɛ ð ɑ
ŋgévə́lɛ̂ðà	ŋ ɡ ɛ v ə l ɛ ð ɑ
ŋgévə́lɛ̂ðá	ŋ ɡ ɛ v ə l ɛ ð ɑ
ŋgéɲávə́lɛ̀ðà	ŋ ɡ ɛ ɲ ɑ v ə l ɛ ð ɑ
ŋgéɲávə́lɛ̀ðá	ŋ ɡ ɛ ɲ ɑ v ə l ɛ ð ɑ
ŋgéɲâvə̀lɛ̀ðà	ŋ ɡ ɛ ɲ ɑ v ə l ɛ ð ɑ
ŋgéɲâvə̀lɛ̀ðá	ŋ ɡ ɛ ɲ ɑ v ə l ɛ ð ɑ
ŋgěɲávlɛ̂ðɔ́	ŋ ɡ ɛ ɲ ɑ v l ɛ ð ɒ
ŋgěɲâvlɛ̀ðɔ́	ŋ ɡ ɛ ɲ ɑ v l ɛ ð ɒ
ŋgìt̪ɔ́	ŋ ɡ i t ɒ
ŋgìðìt̪ɔ́	ŋ ɡ i ð i t ɒ
ŋgìðɔ̀t̪ɔ́	ŋ ɡ i ð ɒ t ɒ
ŋgìðɔ́	ŋ ɡ i ð ɒ
ŋgìɲágɛ́rɛ̀	ŋ ɡ i ɲ ɑ ɡ ɛ ɹ ɛ
ŋgíŋagɛrɛ	ŋ ɡ i ŋ ɑ ɡ ɛ ɹ ɛ
ŋgíɲágɛ́	ŋ ɡ i ɲ ɑ ɡ ɛ
ŋgíɲárvə́lɛ̂ðà	ŋ ɡ i ɲ ɑ ɹ v ə l ɛ ð ɑ
ŋgòó	ŋ ɡ ow ow
ŋgó	ŋ ɡ ow
ŋgúkʊ̀	ŋ ɡ ʉ k ʊ
ŋgûɽì	ŋ ɡ ʉ ɹ i
ŋgwɔ̀t̪ɔ́	ŋ ɡ w ɒ t ɒ
ŋgŋɛɽŋgŋ	ŋ ɡ ŋ ɛ ɹ ŋ ɡ ŋ
ŋgɔ̀tɔ́	ŋ ɡ ɒ t ɒ
ŋgɔ̀t̪ìjí	ŋ ɡ ɒ t i j i
ŋgɔ̀t̪ìnìjí	ŋ ɡ ɒ t i n i j i
ŋgɔ̀t̪ìnɔ̀	ŋ ɡ ɒ t i n ɒ
ŋgɔ̀t̪ìnɔ̀ɔ̌	ŋ ɡ ɒ t i n ɒ ɒ
ŋgɔ̀t̪ɔ́	ŋ ɡ ɒ t ɒ
ŋgɔ̀ðə́nɔ̀ná	ŋ ɡ ɒ ð ə n ɒ n ɑ
ŋgɔ́	ŋ ɡ ɒ
ŋgɔ́cɔ̀	ŋ ɡ ɒ tʃ ɒ
ŋgɔ́dɔ́ŋɔ̀nɔ̀	ŋ ɡ ɒ d ɒ ŋ ɒ n ɒ
ŋgɔ́nì	ŋ ɡ ɒ n i
ŋgɔ́t̪ìnɔ̀	ŋ ɡ ɒ t i n ɒ
ŋgɔ́t̪ìnɛ̀	ŋ ɡ ɒ t i n ɛ
ŋgɔ́t̪ɔ̀	ŋ ɡ ɒ t ɒ
ŋgɔ́ɽɟɛ̀cà	ŋ ɡ ɒ ɹ dʒ ɛ tʃ ɑ
ŋgɔ́ɽɟɛ̀cí	ŋ ɡ ɒ ɹ dʒ ɛ tʃ i
ŋgɔ́ɽɟɛ̀cɔ̀nɔ̀	ŋ ɡ ɒ ɹ dʒ ɛ tʃ ɒ n ɒ
ŋgɔ́ɽɟɛ̀cɔ̀nɔ́	ŋ ɡ ɒ ɹ dʒ ɛ tʃ ɒ n ɒ
ŋgɔ̂ɽcàcìt̪ɔ̀	ŋ ɡ ɒ ɹ tʃ ɑ tʃ i t ɒ
ŋgɔ̂ɽɟàcí	ŋ ɡ ɒ ɹ dʒ ɑ tʃ i
ŋgɔ̌ndì	ŋ ɡ ɒ n d i
ŋgə̀cɛ̀cí	ŋ ɡ ə tʃ ɛ tʃ i
ŋgɛ̀ðɔ́l	ŋ ɡ ɛ ð ɒ l
ŋgɛ̀ðɔ̂l	ŋ ɡ ɛ ð ɒ l
ŋgɛ̀ɲàt̪ɔ́	ŋ ɡ ɛ ɲ ɑ t ɒ
ŋgɛ̀ɲɔ́	ŋ ɡ ɛ ɲ ɒ
ŋgɛ́cì	ŋ ɡ ɛ tʃ i
ŋgɛ́là	ŋ ɡ ɛ l ɑ
ŋgɛ́lǎ	ŋ ɡ ɛ l ɑ
ŋgɛ́lcà	ŋ ɡ ɛ l tʃ ɑ
ŋgɛ́lcì	ŋ ɡ ɛ l tʃ i
ŋgɜ́ù	ŋ ɡ ɐ ʉ
ŋgʊ̀blɔ̀ŋnɔ̀	ŋ ɡ ʊ b l ɒ ŋ n ɒ
ŋi	ŋ i
ŋij̀ɛ́	ŋ i j ɛ
ŋinɔ	ŋ i n ɒ
ŋinɛ	ŋ i n ɛ
ŋiðəŋi	ŋ i ð ə ŋ i
ŋiɲo	ŋ i ɲ ow
ŋì	ŋ i
ŋìà	ŋ i ɑ
ŋìba	ŋ i b ɑ
ŋìcàlò	ŋ i tʃ ɑ l ow
ŋìcèlò	ŋ i tʃ ɛ l ow
ŋìcìlò	ŋ i tʃ i l ow
ŋìcìló	ŋ i tʃ i l ow
ŋìcìlɔ́	ŋ i tʃ i l ɒ
ŋìcílà	ŋ i tʃ i l ɑ
ŋìcílì	ŋ i tʃ i l i
ŋìclò	ŋ i tʃ l ow
ŋìcɔ̀	ŋ i tʃ ɒ
ŋìcɔ́	ŋ i tʃ ɒ
ŋìcɔ́lɔ̀	ŋ i tʃ ɒ l ɒ
ŋìcə̀lò	ŋ i tʃ ə l ow
ŋìcə̀ló	ŋ i tʃ ə l ow
ŋìcə̀lù	ŋ i tʃ ə l ʉ
ŋìcə̀ɾðú	ŋ i tʃ ə ɾ ð ʉ
ŋìc̀lò	ŋ i tʃ l ow
ŋìdí	ŋ i d i
ŋìdɔ̀t̪ɔ́	ŋ i d ɒ t ɒ
ŋìjajɔ́	ŋ i j ɑ j ɒ
ŋìjà	ŋ i j ɑ
ŋìjájɛ̀	ŋ i j ɑ j ɛ
ŋìjéðì	ŋ i j ɛ ð i
ŋìjìnɔ̀	ŋ i j i n ɒ
ŋìjíð̀	ŋ i j i ð
ŋìjɔ̀	ŋ i j ɒ
ŋìjɔ́	ŋ i j ɒ
ŋìjɔ́l	ŋ i j ɒ l
ŋìjɛ́ðà	ŋ i j ɛ ð ɑ
ŋìjɜ̀	ŋ i j ɐ
ŋìnéðàt̪ɛ̀	ŋ i n ɛ ð ɑ t ɛ
ŋìnɔ̀	ŋ i n ɒ
ŋìnɔ̌	ŋ i n ɒ
ŋìnɛ̀	ŋ i n ɛ
ŋìrbɛ̀cì	ŋ i ɹ b ɛ tʃ i
ŋìrcə̀cɔ̀	ŋ i ɹ tʃ ə tʃ ɒ
ŋìrím	ŋ i ɹ i m
ŋìrlɛ̀ɲí	ŋ i ɹ l ɛ ɲ i
ŋìrɛ̀cí	ŋ i ɹ ɛ tʃ i
ŋìt̪ɾɔ̀	ŋ i t ɾ ɒ
ŋìvə̀lɛ̀ðɛ̀	ŋ i v ə l ɛ ð ɛ
ŋìðiŋ̀ní	ŋ i ð i ŋ n i
ŋìðìní	ŋ i ð i n i
ŋìðìníŋìðìní	ŋ i ð i n i ŋ i ð i n i
ŋìðìnt̪ɔ́	ŋ i ð i n t ɒ
ŋìðìnɔ̀	ŋ i ð i n ɒ
ŋìðìnɔ́	ŋ i ð i n ɒ
ŋìðìnɔ́ŋ	ŋ i ð i n ɒ ŋ
ŋìðìnɔ́ŋù	ŋ i ð i n ɒ ŋ ʉ
ŋìðìnɔ̂ɔ́	ŋ i ð i n ɒ ɒ
ŋìðìŋní	ŋ i ð i ŋ n i
ŋìðìɲí	ŋ i ð i ɲ i
ŋìðìɲní	ŋ i ð i ɲ n i
ŋìðə̀ní	ŋ i ð ə n i
ŋìðə̀níìdɔ̀t̪ɔ̀	ŋ i ð ə n i i d ɒ t ɒ
ŋìðə̀nɔ́	ŋ i ð ə n ɒ
ŋìðə̀nɔ́ŋ	ŋ i ð ə n ɒ ŋ
ŋìðə̀nɔ́ŋú	ŋ i ð ə n ɒ ŋ ʉ
ŋìðə̀nɔ́ŋǔ	ŋ i ð ə n ɒ ŋ ʉ
ŋìðə̀nɔ̂	ŋ i ð ə n ɒ
ŋìðə̀nɔ̂ŋ́	ŋ i ð ə n ɒ ŋ
ŋìðə́ní	ŋ i ð ə n i
ŋìðɛ̀ní	ŋ i ð ɛ n i
ŋìðɛ̀níŋà	ŋ i ð ɛ n i ŋ ɑ
ŋìðɛ̀nɔ́	ŋ i ð ɛ n ɒ
ŋìðɛ̀nɔ̂	ŋ i ð ɛ n ɒ
ŋìðɛ̀ŋ̀ní	ŋ i ð ɛ ŋ n i
ŋìðɛ́ní	ŋ i ð ɛ n i
ŋìðɛ́nɔ́	ŋ i ð ɛ n ɒ
ŋìɲára	ŋ i ɲ ɑ ɹ ɑ
ŋìɽáɲìðǐ	ŋ i ɹ ɑ ɲ i ð i
ŋìɽìcàn	ŋ i ɹ i tʃ ɑ n
ŋìɾcɔ̀cɔ̀	ŋ i ɾ tʃ ɒ tʃ ɒ
ŋí	ŋ i
ŋíà	ŋ i ɑ
ŋíbì	ŋ i b i
ŋíbɔ̀	ŋ i b ɒ
ŋícíló	ŋ i tʃ i l ow
ŋícɔ̀	ŋ i tʃ ɒ
ŋícə̀lò	ŋ i tʃ ə l ow
ŋícə̀ló	ŋ i tʃ ə l ow
ŋícə́ló	ŋ i tʃ ə l ow
ŋícɛ̀	ŋ i tʃ ɛ
ŋídì	ŋ i d i
ŋídìì	ŋ i d i i
ŋídìjì	ŋ i d i j i
ŋídìjí	ŋ i d i j i
ŋídìðɔ̀	ŋ i d i ð ɒ
ŋídìðɔ̀ndà	ŋ i d i ð ɒ n d ɑ
ŋídí	ŋ i d i
ŋídíjí	ŋ i d i j i
ŋídɔ̀	ŋ i d ɒ
ŋídɔ̀t̪ɔ́	ŋ i d ɒ t ɒ
ŋídɔ́	ŋ i d ɒ
ŋídɔ̂	ŋ i d ɒ
ŋíjà	ŋ i j ɑ
ŋíjɔ̀	ŋ i j ɒ
ŋíjɔ́	ŋ i j ɒ
ŋíjɔ́l	ŋ i j ɒ l
ŋíjɛ̀	ŋ i j ɛ
ŋílɔ̀t̪ɔ̀	ŋ i l ɒ t ɒ
ŋílɔ̀ðɔ̀	ŋ i l ɒ ð ɒ
ŋílɛ̀t̪ɛ̀	ŋ i l ɛ t ɛ
ŋílɛ̀ðɛ̀	ŋ i l ɛ ð ɛ
ŋín	ŋ i n
ŋínd̪ɔ̀t̪ɔ̀	ŋ i n d ɒ t ɒ
ŋínd̪ɔ̀t̪ɛ̀	ŋ i n d ɒ t ɛ
ŋínɛ̀	ŋ i n ɛ
ŋínɛ́	ŋ i n ɛ
ŋípíjò	ŋ i p i j ow
ŋípíjó	ŋ i p i j ow
ŋípíjɔ́	ŋ i p i j ɒ
ŋírdɔ̀cɔ̀	ŋ i ɹ d ɒ tʃ ɒ
ŋírìcɛ̀cì	ŋ i ɹ i tʃ ɛ tʃ i
ŋírìcɛ̀cɔ̀	ŋ i ɹ i tʃ ɛ tʃ ɒ
ŋírɔ́t̪ɛ̌	ŋ i ɹ ɒ t ɛ
ŋívə̀lɛ̀ðɛ̀	ŋ i v ə l ɛ ð ɛ
ŋívə́lɛ̂ðɛ̀	ŋ i v ə l ɛ ð ɛ
ŋíð	ŋ i ð
ŋíðìnɔ̀	ŋ i ð i n ɒ
ŋíðìnɔ́	ŋ i ð i n ɒ
ŋíðìnɔ́ŋù	ŋ i ð i n ɒ ŋ ʉ
ŋíðíní	ŋ i ð i n i
ŋíðíŋí	ŋ i ð i ŋ i
ŋíðɔ̀	ŋ i ð ɒ
ŋíðə̀ní	ŋ i ð ə n i
ŋíðə̀nɔ́	ŋ i ð ə n ɒ
ŋíðə̀nɔ́ŋ	ŋ i ð ə n ɒ ŋ
ŋíðə́ní	ŋ i ð ə n i
ŋíðə́nɔ́	ŋ i ð ə n ɒ
ŋíðɛ̀	ŋ i ð ɛ
ŋíðɛ́ní	ŋ i ð ɛ n i
ŋíɲár	ŋ i ɲ ɑ ɹ
ŋíɲárvə́lɛ̀ðà	ŋ i ɲ ɑ ɹ v ə l ɛ ð ɑ
ŋíɲé	ŋ i ɲ ɛ
ŋíɽìcàn	ŋ i ɹ i tʃ ɑ n
ŋíɽìcǎn	ŋ i ɹ i tʃ ɑ n
ŋí́ɲɛ́	ŋ i ɲ ɛ
ŋî	ŋ i
ŋîrá	ŋ i ɹ ɑ
ŋîŋ	ŋ i ŋ
ŋîɾa	ŋ i ɾ ɑ
ŋî́	ŋ i
ŋǐn	ŋ i n
ŋkàɾó	ŋ k ɑ ɾ ow
ŋkâɾcí	ŋ k ɑ ɾ tʃ i
ŋkéɲà	ŋ k ɛ ɲ ɑ
ŋkéɲɛ̀	ŋ k ɛ ɲ ɛ
ŋkɔ́t̪à	ŋ k ɒ t ɑ
ŋmbɽò	ŋ m b ɹ ow
ŋmíɲàt̪ɛ̀	ŋ m i ɲ ɑ t ɛ
ŋmɛ̀ðàt̪ɛ̀	ŋ m ɛ ð ɑ t ɛ
ŋmɛ́ðàt̪ɛ̀	ŋ m ɛ ð ɑ t ɛ
ŋmɛ́ðát̪ɛ̀	ŋ m ɛ ð ɑ t ɛ
ŋmɽàrè	ŋ m ɹ ɑ ɹ ɛ
ŋmɽàrɛ̀	ŋ m ɹ ɑ ɹ ɛ
ŋmɽáɾɛ̀	ŋ m ɹ ɑ ɾ ɛ
ŋn	ŋ n
ŋná	ŋ n ɑ
ŋnɔ̀nɔ́	ŋ n ɒ n ɒ
ŋo	ŋ ow
ŋòdò	ŋ ow d ow
ŋòlò	ŋ ow l ow
ŋòló	ŋ ow l ow
ŋòrà	ŋ ow ɹ ɑ
ŋòrò	ŋ ow ɹ ow
ŋòró	ŋ ow ɹ ow
ŋòrô	ŋ ow ɹ ow
ŋòú	ŋ ow ʉ
ŋòðà	ŋ ow ð ɑ
ŋòɽòn	ŋ ow ɹ ow n
ŋòɽón	ŋ ow ɹ ow n
ŋòɾà	ŋ ow ɾ ɑ
ŋòɾá	ŋ ow ɾ ɑ
ŋó	ŋ ow
ŋórá	ŋ ow ɹ ɑ
ŋóɽê	ŋ ow ɹ ɛ
ŋóɽêŋɛ̀	ŋ ow ɹ ɛ ŋ ɛ
ŋóɽùwɛ́l	ŋ ow ɹ ʉ w ɛ l
ŋóɽɛ́	ŋ ow ɹ ɛ
ŋràráò	ŋ ɹ ɑ ɹ ɑ ow
ŋrlɛ̀ɲí	ŋ ɹ l ɛ ɲ i
ŋrɔ̀t̪ɔ́	ŋ ɹ ɒ t ɒ
ŋrɔ́bà	ŋ ɹ ɒ b ɑ
ŋrɔ̂bà	ŋ ɹ ɒ b ɑ
ŋrɛ́	ŋ ɹ ɛ
ŋŕdà	ŋ ɹ d ɑ
ŋŕdɛ̀	ŋ ɹ d ɛ
ŋtà	ŋ t ɑ
ŋtá	ŋ t ɑ
ŋt̪ɔ́t̪à	ŋ t ɒ t ɑ
ŋt̪ɔ́t̪ɛ̀	ŋ t ɒ t ɛ
ŋucɔ	ŋ ʉ tʃ ɒ
ŋù	ŋ ʉ
ŋùbòrùbúrɛ́	ŋ ʉ b ow ɹ ʉ b ʉ ɹ ɛ
ŋùbúrŋɛ̀	ŋ ʉ b ʉ ɹ ŋ ɛ
ŋùbútù	ŋ ʉ b ʉ t ʉ
ŋùbút̪ú	ŋ ʉ b ʉ t ʉ
ŋùbút̪ɛ̀	ŋ ʉ b ʉ t ɛ
ŋùbə́ɽà	ŋ ʉ b ə ɹ ɑ
ŋùbə́ɽɛ̀	ŋ ʉ b ə ɹ ɛ
ŋùcò	ŋ ʉ tʃ ow
ŋùcɔ́	ŋ ʉ tʃ ɒ
ŋùdo	ŋ ʉ d ow
ŋùdòɾè	ŋ ʉ d ow ɾ ɛ
ŋùdòɾèɲà	ŋ ʉ d ow ɾ ɛ ɲ ɑ
ŋùdòɾě	ŋ ʉ d ow ɾ ɛ
ŋùdó	ŋ ʉ d ow
ŋùdóŋâɲà	ŋ ʉ d ow ŋ ɑ ɲ ɑ
ŋùdóŋɛ́	ŋ ʉ d ow ŋ ɛ
ŋùdóɾŋɛ́ŋầɲà	ŋ ʉ d ow ɾ ŋ ɛ ŋ ɑ ɲ ɑ
ŋùdùɛ̀t̪ɛ̀	ŋ ʉ d ʉ ɛ t ɛ
ŋùdúrì	ŋ ʉ d ʉ ɹ i
ŋùdúrɔ̀	ŋ ʉ d ʉ ɹ ɒ
ŋùdúŋàɲà	ŋ ʉ d ʉ ŋ ɑ ɲ ɑ
ŋùdúŋɛ́	ŋ ʉ d ʉ ŋ ɛ
ŋùdúɛ̀t̪ɛ̌	ŋ ʉ d ʉ ɛ t ɛ
ŋùdɔ́	ŋ ʉ d ɒ
ŋùd̪ǔ	ŋ ʉ d ʉ
ŋùlà	ŋ ʉ l ɑ
ŋùlá	ŋ ʉ l ɑ
ŋùmbɽó	ŋ ʉ m b ɹ ow
ŋùrìjɔ̀	ŋ ʉ ɹ i j ɒ
ŋùrìjɔ́	ŋ ʉ ɹ i j ɒ
ŋùrìjɔ̌	ŋ ʉ ɹ i j ɒ
ŋùró	ŋ ʉ ɹ ow
ŋùrù	ŋ ʉ ɹ ʉ
ŋùt̪ì	ŋ ʉ t i
ŋùðà	ŋ ʉ ð ɑ
ŋùðǎ	ŋ ʉ ð ɑ
ŋùðì	ŋ ʉ ð i
ŋùðɛ́r	ŋ ʉ ð ɛ ɹ
ŋùðɛ́ɾɛ́	ŋ ʉ ð ɛ ɾ ɛ
ŋùɽbí	ŋ ʉ ɹ b i
ŋùɽbɔ́	ŋ ʉ ɹ b ɒ
ŋùɽùvɔ́	ŋ ʉ ɹ ʉ v ɒ
ŋùɽví	ŋ ʉ ɹ v i
ŋùɽɟɛ̀n	ŋ ʉ ɹ dʒ ɛ n
ŋùɽɟɛ́nɛ́	ŋ ʉ ɹ dʒ ɛ n ɛ
ŋùɾìjɔ́	ŋ ʉ ɾ i j ɒ
ŋú	ŋ ʉ
ŋúbútɛ́	ŋ ʉ b ʉ t ɛ
ŋúcɔ̀	ŋ ʉ tʃ ɒ
ŋúcɔ́	ŋ ʉ tʃ ɒ
ŋúcɔ̌	ŋ ʉ tʃ ɒ
ŋúdì	ŋ ʉ d i
ŋúdòɾì	ŋ ʉ d ow ɾ i
ŋúdòɾí	ŋ ʉ d ow ɾ i
ŋúdòɾǐ	ŋ ʉ d ow ɾ i
ŋúdúɛ̀t̪ɛ̀	ŋ ʉ d ʉ ɛ t ɛ
ŋúdɔ̀	ŋ ʉ d ɒ
ŋúdɛ̀	ŋ ʉ d ɛ
ŋúgɔ̀	ŋ ʉ ɡ ɒ
ŋúgɔ́	ŋ ʉ ɡ ɒ
ŋúiò	ŋ ʉ i ow
ŋúmb	ŋ ʉ m b
ŋúmbə́ɽó	ŋ ʉ m b ə ɹ ow
ŋúmbɽó	ŋ ʉ m b ɹ ow
ŋúmɔ̀ðɔ̀	ŋ ʉ m ɒ ð ɒ
ŋúmɔ̀ðɛ̀	ŋ ʉ m ɒ ð ɛ
ŋúmɔ́n	ŋ ʉ m ɒ n
ŋúmɔ́ná	ŋ ʉ m ɒ n ɑ
ŋúrì	ŋ ʉ ɹ i
ŋúrmʊ̀ðɔ̀	ŋ ʉ ɹ m ʊ ð ɒ
ŋúrmʊ̀ðɛ̀	ŋ ʉ ɹ m ʊ ð ɛ
ŋúrɔ̀	ŋ ʉ ɹ ɒ
ŋútìðì	ŋ ʉ t i ð i
ŋútìðɔ̀	ŋ ʉ t i ð ɒ
ŋút̪ùlínâ	ŋ ʉ t ʉ l i n ɑ
ŋút̪ùlú	ŋ ʉ t ʉ l ʉ
ŋút̪ɔ̀nɔ̀	ŋ ʉ t ɒ n ɒ
ŋúwɔ̀	ŋ ʉ w ɒ
ŋúwɔ́	ŋ ʉ w ɒ
ŋúðà	ŋ ʉ ð ɑ
ŋúðàr	ŋ ʉ ð ɑ ɹ
ŋúðǎ	ŋ ʉ ð ɑ
ŋúðɛ	ŋ ʉ ð ɛ
ŋúðɛr	ŋ ʉ ð ɛ ɹ
ŋúðɛ̀r	ŋ ʉ ð ɛ ɹ
ŋúðɛ́r	ŋ ʉ ð ɛ ɹ
ŋúŋ	ŋ ʉ ŋ
ŋúɔ́	ŋ ʉ ɒ
ŋúɽcà	ŋ ʉ ɹ tʃ ɑ
ŋúɽcì	ŋ ʉ ɹ tʃ i
ŋúɽìt̪à	ŋ ʉ ɹ i t ɑ
ŋúɽìt̪ɛ̀	ŋ ʉ ɹ i t ɛ
ŋúɽìðà	ŋ ʉ ɹ i ð ɑ
ŋúɽìðì	ŋ ʉ ɹ i ð i
ŋúɽìðí	ŋ ʉ ɹ i ð i
ŋúɽíɲɛ́	ŋ ʉ ɹ i ɲ ɛ
ŋúɽíɲɛ̂	ŋ ʉ ɹ i ɲ ɛ
ŋúɽî	ŋ ʉ ɹ i
ŋúɽðìðì	ŋ ʉ ɹ ð i ð i
ŋúɽðìðɔ̀	ŋ ʉ ɹ ð i ð ɒ
ŋúɽɟɛ́nɛ̀	ŋ ʉ ɹ dʒ ɛ n ɛ
ŋúɾɛ̀	ŋ ʉ ɾ ɛ
ŋúɾɛ́	ŋ ʉ ɾ ɛ
ŋûŋ	ŋ ʉ ŋ
ŋvə́lɛ̀ðɛ̀	ŋ v ə l ɛ ð ɛ
ŋwànà	ŋ w ɑ n ɑ
ŋwájìnì	ŋ w ɑ j i n i
ŋwt̪út̪ù	ŋ w t ʉ t ʉ
ŋwuna	ŋ w ʉ n ɑ
ŋwùbútú	ŋ w ʉ b ʉ t ʉ
ŋwùt̪út̪ú	ŋ w ʉ t ʉ t ʉ
ŋwɔ̀rà	ŋ w ɒ ɹ ɑ
ŋwɔ̀rá	ŋ w ɒ ɹ ɑ
ŋwɔ̀ɲá	ŋ w ɒ ɲ ɑ
ŋwɔ́	ŋ w ɒ
ŋwɔ́bɛ́ɽɛ́	ŋ w ɒ b ɛ ɹ ɛ
ŋwɔ́rà	ŋ w ɒ ɹ ɑ
ŋwɔ́rǎ	ŋ w ɒ ɹ ɑ
ŋwɜ́t̪í	ŋ w ɐ t i
ŋwʊɲʊ	ŋ w ʊ ɲ ʊ
ŋŋìðə̀ní	ŋ ŋ i ð ə n i
ŋŋə̀mà	ŋ ŋ ə m ɑ
ŋŋə̀má	ŋ ŋ ə m ɑ
ŋŋə́mànô	ŋ ŋ ə m ɑ n ow
ŋɔ̀bò	ŋ ɒ b ow
ŋɔ̀bó	ŋ ɒ b ow
ŋɔ̀dɔ̀rì	ŋ ɒ d ɒ ɹ i
ŋɔ̀là	ŋ ɒ l ɑ
ŋɔ̀mɔ̀	ŋ ɒ m ɒ
ŋɔ̀mɔ̀ðá	ŋ ɒ m ɒ ð ɑ
ŋɔ̀mɔ̀ðâ	ŋ ɒ m ɒ ð ɑ
ŋɔ̀mɔ̌	ŋ ɒ m ɒ
ŋɔ̀nɔ̀nɔ́	ŋ ɒ n ɒ n ɒ
ŋɔ̀nɲà	ŋ ɒ n ɲ ɑ
ŋɔ̀ra	ŋ ɒ ɹ ɑ
ŋɔ̀rà	ŋ ɒ ɹ ɑ
ŋɔ̀ràŋrá	ŋ ɒ ɹ ɑ ŋ ɹ ɑ
ŋɔ̀rá	ŋ ɒ ɹ ɑ
ŋɔ̀rǎ	ŋ ɒ ɹ ɑ
ŋɔ̀rɛ̀	ŋ ɒ ɹ ɛ
ŋɔ̀t̪ɔ̀	ŋ ɒ t ɒ
ŋɔ̀t̪ɔ́	ŋ ɒ t ɒ
ŋɔ̀ðɔ̀	ŋ ɒ ð ɒ
ŋɔ̀ɲà	ŋ ɒ ɲ ɑ
ŋɔ̀ɲɔ̀	ŋ ɒ ɲ ɒ
ŋɔ̀ɲɔ́	ŋ ɒ ɲ ɒ
ŋɔ̀ɽíŋgɔ̀	ŋ ɒ ɹ i ŋ ɡ ɒ
ŋɔ̀ɽíŋgɔ́	ŋ ɒ ɹ i ŋ ɡ ɒ
ŋɔ̀ɽɔ̀mɛ̀	ŋ ɒ ɹ ɒ m ɛ
ŋɔ̀ɾà	ŋ ɒ ɾ ɑ
ŋɔ̀ɾǎ	ŋ ɒ ɾ ɑ
ŋɔ́	ŋ ɒ
ŋɔ́cɔ́	ŋ ɒ tʃ ɒ
ŋɔ́cɛ̀	ŋ ɒ tʃ ɛ
ŋɔ́cɛ́	ŋ ɒ tʃ ɛ
ŋɔ́dà	ŋ ɒ d ɑ
ŋɔ́dɔ̀	ŋ ɒ d ɒ
ŋɔ́dɔ̀rì	ŋ ɒ d ɒ ɹ i
ŋɔ́dɔ̀ŋnà	ŋ ɒ d ɒ ŋ n ɑ
ŋɔ́dɔ́rì	ŋ ɒ d ɒ ɹ i
ŋɔ́dɛ̀	ŋ ɒ d ɛ
ŋɔ́lá	ŋ ɒ l ɑ
ŋɔ́mɔ̀	ŋ ɒ m ɒ
ŋɔ́mɔ̀ŋnɔ̀	ŋ ɒ m ɒ ŋ n ɒ
ŋɔ́mɔ̀ŋnɛ̀	ŋ ɒ m ɒ ŋ n ɛ
ŋɔ́mɔ́	ŋ ɒ m ɒ
ŋɔ́mɔ́n	ŋ ɒ m ɒ n
ŋɔ́mɔ́nɛ̀	ŋ ɒ m ɒ n ɛ
ŋɔ́mɔ́nɛ́	ŋ ɒ m ɒ n ɛ
ŋɔ́mɔ̌	ŋ ɒ m ɒ
ŋɔ́mɛ́	ŋ ɒ m ɛ
ŋɔ́nà	ŋ ɒ n ɑ
ŋɔ́nì	ŋ ɒ n i
ŋɔ́nt̪ɔ̀	ŋ ɒ n t ɒ
ŋɔ́nɔ̀	ŋ ɒ n ɒ
ŋɔ́nɔ́nà	ŋ ɒ n ɒ n ɑ
ŋɔ́nɛ̀	ŋ ɒ n ɛ
ŋɔ́rɔ́	ŋ ɒ ɹ ɒ
ŋɔ́t̪ɔ́	ŋ ɒ t ɒ
ŋɔ́vɛ́ɽɛ́	ŋ ɒ v ɛ ɹ ɛ
ŋɔ́ðɔ́	ŋ ɒ ð ɒ
ŋɔ́ðɔ́únɛ́rɛ̀	ŋ ɒ ð ɒ ʉ n ɛ ɹ ɛ
ŋɔ́ðɔ́ŋ	ŋ ɒ ð ɒ ŋ
ŋɔ́ðə̀ŋìnà	ŋ ɒ ð ə ŋ i n ɑ
ŋɔ́ðɛ́	ŋ ɒ ð ɛ
ŋɔ́ŋɔ̀ŋnìjì	ŋ ɒ ŋ ɒ ŋ n i j i
ŋɔ́ŋɔ̀ŋnìjɔ̀	ŋ ɒ ŋ ɒ ŋ n i j ɒ
ŋɔ́ŋɔ̀ŋnɔ̀	ŋ ɒ ŋ ɒ ŋ n ɒ
ŋɔ́ŋɔ̀ŋnɛ̀	ŋ ɒ ŋ ɒ ŋ n ɛ
ŋɔ́ŋɔ́	ŋ ɒ ŋ ɒ
ŋɔ́ɲà	ŋ ɒ ɲ ɑ
ŋɔ́ɽà	ŋ ɒ ɹ ɑ
ŋɔ́ɽíŋgɔ́	ŋ ɒ ɹ i ŋ ɡ ɒ
ŋɔ́ɽɛ̀	ŋ ɒ ɹ ɛ
ŋɔ́ɽɛ́	ŋ ɒ ɹ ɛ
ŋɔ́ɽɟɛ̀cà	ŋ ɒ ɹ dʒ ɛ tʃ ɑ
ŋɔ́ɽɟɛ̀cì	ŋ ɒ ɹ dʒ ɛ tʃ i
ŋɔ́ɽɟɛ́nɛ́	ŋ ɒ ɹ dʒ ɛ n ɛ
ŋɔ́ɾá	ŋ ɒ ɾ ɑ
ŋɔ́ɾánò	ŋ ɒ ɾ ɑ n ow
ŋɔ́ɾɔ̀	ŋ ɒ ɾ ɒ
ŋɔ́ɾɛ̀	ŋ ɒ ɾ ɛ
ŋɔ̂mɽɔ̀	ŋ ɒ m ɹ ɒ
ŋɔ̂t̪ɔ́	ŋ ɒ t ɒ
ŋɔ̂ɽàt̪àt̪ɛ̀	ŋ ɒ ɹ ɑ t ɑ t ɛ
ŋɔ̂ɽàt̪àt̪ɛ́	ŋ ɒ ɹ ɑ t ɑ t ɛ
ŋɔ̂ɽàt̪ɔ́	ŋ ɒ ɹ ɑ t ɒ
ŋɔ̂ɽìt̪ɔ̀	ŋ ɒ ɹ i t ɒ
ŋɔ̂ɽìt̪ɔ́	ŋ ɒ ɹ i t ɒ
ŋɔ̌ɽà	ŋ ɒ ɹ ɑ
ŋɔ̌ɽàt̪àǎ	ŋ ɒ ɹ ɑ t ɑ ɑ
ŋə	ŋ ə
ŋəra	ŋ ə ɹ ɑ
ŋəramna	ŋ ə ɹ ɑ m n ɑ
ŋəvəlɛðɛ	ŋ ə v ə l ɛ ð ɛ
ŋə̀	ŋ ə
ŋə̀bó	ŋ ə b ow
ŋə̀búrŋà	ŋ ə b ʉ ɹ ŋ ɑ
ŋə̀búrŋɛ̀	ŋ ə b ʉ ɹ ŋ ɛ
ŋə̀cá	ŋ ə tʃ ɑ
ŋə̀cíŋgɛ̀làlà	ŋ ə tʃ i ŋ ɡ ɛ l ɑ l ɑ
ŋə̀cíŋgɛ̀làlì	ŋ ə tʃ i ŋ ɡ ɛ l ɑ l i
ŋə̀cɔ́	ŋ ə tʃ ɒ
ŋə̀dɔ́ŋðà	ŋ ə d ɒ ŋ ð ɑ
ŋə̀dɔ́ŋðɛ̀	ŋ ə d ɒ ŋ ð ɛ
ŋə̀írdɔ̀cɔ̀	ŋ ə i ɹ d ɒ tʃ ɒ
ŋə̀líŋt̪à	ŋ ə l i ŋ t ɑ
ŋə̀líŋt̪ɛ̀	ŋ ə l i ŋ t ɛ
ŋə̀mà	ŋ ə m ɑ
ŋə̀màð	ŋ ə m ɑ ð
ŋə̀mbrá	ŋ ə m b ɹ ɑ
ŋə̀mbré	ŋ ə m b ɹ ɛ
ŋə̀mbùɽú	ŋ ə m b ʉ ɹ ʉ
ŋə̀mìɲàt̪ɔ́	ŋ ə m i ɲ ɑ t ɒ
ŋə̀míɲà	ŋ ə m i ɲ ɑ
ŋə̀míɲɛ̀	ŋ ə m i ɲ ɛ
ŋə̀mt̪ɛ́ɾɛ̀	ŋ ə m t ɛ ɾ ɛ
ŋə̀mt̪ɛ́ɾɛ́	ŋ ə m t ɛ ɾ ɛ
ŋə̀mt̪ɛ́ɾɛ̂	ŋ ə m t ɛ ɾ ɛ
ŋə̀mùt̪ɔ́l	ŋ ə m ʉ t ɒ l
ŋə̀mút̪ə̀nɔ̀	ŋ ə m ʉ t ə n ɒ
ŋə̀mút̪ə̀nɛ̀	ŋ ə m ʉ t ə n ɛ
ŋə̀mɔ́ð	ŋ ə m ɒ ð
ŋə̀mɛ́ðà	ŋ ə m ɛ ð ɑ
ŋə̀mɛ́ðɛ̀	ŋ ə m ɛ ð ɛ
ŋə̀ná	ŋ ə n ɑ
ŋə̀nɔ̀nt̪ɔ̀t̪ɔ́	ŋ ə n ɒ n t ɒ t ɒ
ŋə̀nɔ̀nɔ́	ŋ ə n ɒ n ɒ
ŋə̀nɔ́nà	ŋ ə n ɒ n ɑ
ŋə̀nɔ́nɛ̀	ŋ ə n ɒ n ɛ
ŋə̀nɛ́ðà	ŋ ə n ɛ ð ɑ
ŋə̀nɛ́ðɛ̀	ŋ ə n ɛ ð ɛ
ŋə̀pì	ŋ ə p i
ŋə̀pí	ŋ ə p i
ŋə̀pít̪ɛ̀	ŋ ə p i t ɛ
ŋə̀ràmnà	ŋ ə ɹ ɑ m n ɑ
ŋə̀ràmná	ŋ ə ɹ ɑ m n ɑ
ŋə̀ràmnámnà	ŋ ə ɹ ɑ m n ɑ m n ɑ
ŋə̀rá	ŋ ə ɹ ɑ
ŋə̀rácà	ŋ ə ɹ ɑ tʃ ɑ
ŋə̀rácì	ŋ ə ɹ ɑ tʃ i
ŋə̀rì	ŋ ə ɹ i
ŋə̀rǐ	ŋ ə ɹ i
ŋə̀rnɔ̀nɔ́	ŋ ə ɹ n ɒ n ɒ
ŋə̀rt̪á	ŋ ə ɹ t ɑ
ŋə̀rt̪ǎ	ŋ ə ɹ t ɑ
ŋə̀rt̪ɔ́	ŋ ə ɹ t ɒ
ŋə̀rvɔ́	ŋ ə ɹ v ɒ
ŋə̀rðɛ̀cà	ŋ ə ɹ ð ɛ tʃ ɑ
ŋə̀rə̀mnà	ŋ ə ɹ ə m n ɑ
ŋə̀rɛ̀	ŋ ə ɹ ɛ
ŋə̀rɛ̀mnà	ŋ ə ɹ ɛ m n ɑ
ŋə̀rɛ̀mná	ŋ ə ɹ ɛ m n ɑ
ŋə̀rɛ̀mnámnà	ŋ ə ɹ ɛ m n ɑ m n ɑ
ŋə̀r̀mná	ŋ ə ɹ m n ɑ
ŋə̀ŕlànd̪à	ŋ ə ɹ l ɑ n d ɑ
ŋə̀ŕlànd̪ɛ̀	ŋ ə ɹ l ɑ n d ɛ
ŋə̀ŕlɛ̀ɲì	ŋ ə ɹ l ɛ ɲ i
ŋə̀ŕlɛ̀ɲɔ̀	ŋ ə ɹ l ɛ ɲ ɒ
ŋə̀tútɔ̀	ŋ ə t ʉ t ɒ
ŋə̀tútɛ̀	ŋ ə t ʉ t ɛ
ŋə̀tɾì	ŋ ə t ɾ i
ŋə̀t̪ɔ́ɽà	ŋ ə t ɒ ɹ ɑ
ŋə̀t̪ɔ́ɽɛ̀	ŋ ə t ɒ ɹ ɛ
ŋə̀t̪ə́và	ŋ ə t ə v ɑ
ŋə̀t̪ə́vɛ̀	ŋ ə t ə v ɛ
ŋə̀t̪ɾɔ̀	ŋ ə t ɾ ɒ
ŋə̀vàrà	ŋ ə v ɑ ɹ ɑ
ŋə̀vàvrì	ŋ ə v ɑ v ɹ i
ŋə̀vàvɾì	ŋ ə v ɑ v ɾ i
ŋə̀váɾà	ŋ ə v ɑ ɾ ɑ
ŋə̀váɾì	ŋ ə v ɑ ɾ i
ŋə̀vè	ŋ ə v ɛ
ŋə̀vrà	ŋ ə v ɹ ɑ
ŋə̀vráðà	ŋ ə v ɹ ɑ ð ɑ
ŋə̀vráðɛ̀	ŋ ə v ɹ ɑ ð ɛ
ŋə̀vŕðɔ̀	ŋ ə v ɹ ð ɒ
ŋə̀vŕðɛ̀	ŋ ə v ɹ ð ɛ
ŋə̀vɔ́ɽɔ̀	ŋ ə v ɒ ɹ ɒ
ŋə̀və̀lɛ̀ðɔ́	ŋ ə v ə l ɛ ð ɒ
ŋə̀və́lɔ̀cɔ̀	ŋ ə v ə l ɒ tʃ ɒ
ŋə̀və́lɛ̀cì	ŋ ə v ə l ɛ tʃ i
ŋə̀və́lɛ̀ðà	ŋ ə v ə l ɛ ð ɑ
ŋə̀və́lɛ̀ðɛ̀	ŋ ə v ə l ɛ ð ɛ
ŋə̀və́r	ŋ ə v ə ɹ
ŋə̀və́rá	ŋ ə v ə ɹ ɑ
ŋə̀və́râ	ŋ ə v ə ɹ ɑ
ŋə̀vɛ̀r	ŋ ə v ɛ ɹ
ŋə̀vɛ́	ŋ ə v ɛ
ŋə̀vɜ́ɽì	ŋ ə v ɐ ɹ i
ŋə̀ðèní	ŋ ə ð ɛ n i
ŋə̀ðùɽú	ŋ ə ð ʉ ɹ ʉ
ŋə̀ðə̀	ŋ ə ð ə
ŋə̀ðə̀ŋná	ŋ ə ð ə ŋ n ɑ
ŋə̀ɟíðì	ŋ ə dʒ i ð i
ŋə̀ɟíðɔ̀	ŋ ə dʒ i ð ɒ
ŋə̀ɲə́làcà	ŋ ə ɲ ə l ɑ tʃ ɑ
ŋə̀ɲə́làci	ŋ ə ɲ ə l ɑ tʃ i
ŋə̀ɽà	ŋ ə ɹ ɑ
ŋə̀ɽá	ŋ ə ɹ ɑ
ŋə̀ɽíɲà	ŋ ə ɹ i ɲ ɑ
ŋə̀ɽíɲɛ̀	ŋ ə ɹ i ɲ ɛ
ŋə̀ɾímɛ́	ŋ ə ɾ i m ɛ
ŋə́	ŋ ə
ŋə́bàɽà	ŋ ə b ɑ ɹ ɑ
ŋə́dì	ŋ ə d i
ŋə́l	ŋ ə l
ŋə́lácà	ŋ ə l ɑ tʃ ɑ
ŋə́lácì	ŋ ə l ɑ tʃ i
ŋə́lvə́lɛ̀ðɛ̀	ŋ ə l v ə l ɛ ð ɛ
ŋə́lɛ́vcà	ŋ ə l ɛ v tʃ ɑ
ŋə́lɛ́vcì	ŋ ə l ɛ v tʃ i
ŋə́lɛ́ŋcà	ŋ ə l ɛ ŋ tʃ ɑ
ŋə́lɛ́ŋcì	ŋ ə l ɛ ŋ tʃ i
ŋə́mà	ŋ ə m ɑ
ŋə́mànʊ́	ŋ ə m ɑ n ʊ
ŋə́máðɛ̀	ŋ ə m ɑ ð ɛ
ŋə́máðɛ́	ŋ ə m ɑ ð ɛ
ŋə́mt̪ɛ́ɾá	ŋ ə m t ɛ ɾ ɑ
ŋə́mt̪ɛ́ɾɛ́	ŋ ə m t ɛ ɾ ɛ
ŋə́mɛ̀	ŋ ə m ɛ
ŋə́nà	ŋ ə n ɑ
ŋə́ndà	ŋ ə n d ɑ
ŋə́ndì	ŋ ə n d i
ŋə́nɛ̀	ŋ ə n ɛ
ŋə́píjɔ́	ŋ ə p i j ɒ
ŋə́pɔ̀	ŋ ə p ɒ
ŋə́pɛ̀	ŋ ə p ɛ
ŋə́rà	ŋ ə ɹ ɑ
ŋə́ràmná	ŋ ə ɹ ɑ m n ɑ
ŋə́rá	ŋ ə ɹ ɑ
ŋə́rámnàmnà	ŋ ə ɹ ɑ m n ɑ m n ɑ
ŋə́rì	ŋ ə ɹ i
ŋə́rlɛ̀ɲí	ŋ ə ɹ l ɛ ɲ i
ŋə́rtá	ŋ ə ɹ t ɑ
ŋə́rt̪à	ŋ ə ɹ t ɑ
ŋə́rt̪á	ŋ ə ɹ t ɑ
ŋə́rt̪ɔ̀	ŋ ə ɹ t ɒ
ŋə́rt̪ɔ́	ŋ ə ɹ t ɒ
ŋə́rðà	ŋ ə ɹ ð ɑ
ŋə́rðɛ̀	ŋ ə ɹ ð ɛ
ŋə́rə̀mná	ŋ ə ɹ ə m n ɑ
ŋə́rɛ̀	ŋ ə ɹ ɛ
ŋə́rɛ̀mnà	ŋ ə ɹ ɛ m n ɑ
ŋə́rɛ̀mná	ŋ ə ɹ ɛ m n ɑ
ŋə́rɛ́mnà	ŋ ə ɹ ɛ m n ɑ
ŋə́rɛ̂mnɛ̀t̪ɛ̀	ŋ ə ɹ ɛ m n ɛ t ɛ
ŋə́t̪à	ŋ ə t ɑ
ŋə́t̪ì	ŋ ə t i
ŋə́t̪ɔ̀	ŋ ə t ɒ
ŋə́t̪ə́và	ŋ ə t ə v ɑ
ŋə́və́lɛ̀ðà	ŋ ə v ə l ɛ ð ɑ
ŋə́və́lɛ̀ðɛ̀	ŋ ə v ə l ɛ ð ɛ
ŋə́wájà	ŋ ə w ɑ j ɑ
ŋə́wájì	ŋ ə w ɑ j i
ŋə́ðà	ŋ ə ð ɑ
ŋə́ðə̀ŋnɛ̀	ŋ ə ð ə ŋ n ɛ
ŋə́ðə́ŋnɛ̀	ŋ ə ð ə ŋ n ɛ
ŋə́ðɛ̀	ŋ ə ð ɛ
ŋə́ð̀àŋàl	ŋ ə ð ɑ ŋ ɑ l
ŋə́ɲárvə́lɛ̀ðɛ̀	ŋ ə ɲ ɑ ɹ v ə l ɛ ð ɛ
ŋə́ɽà	ŋ ə ɹ ɑ
ŋə́ɽá	ŋ ə ɹ ɑ
ŋə́ɽáj	ŋ ə ɹ ɑ j
ŋə́ɽɛ́jŋð̀àŋàl	ŋ ə ɹ ɛ j ŋ ð ɑ ŋ ɑ l
ŋə́́ɽá	ŋ ə ɹ ɑ
ŋɛnɔ́nɛ̀	ŋ ɛ n ɒ n ɛ
ŋɛ̀	ŋ ɛ
ŋɛ̀cə̀lò	ŋ ɛ tʃ ə l ow
ŋɛ̀l	ŋ ɛ l
ŋɛ̀má	ŋ ɛ m ɑ
ŋɛ̀mbrâ	ŋ ɛ m b ɹ ɑ
ŋɛ̀mùt̪̀	ŋ ɛ m ʉ t
ŋɛ̀mɛ́	ŋ ɛ m ɛ
ŋɛ̀n	ŋ ɛ n
ŋɛ̀nɔ̀nìnɔ̀	ŋ ɛ n ɒ n i n ɒ
ŋɛ̀nɔ̀nìnɔ́	ŋ ɛ n ɒ n i n ɒ
ŋɛ̀nɔ̀nìnɔ̂ɔ́	ŋ ɛ n ɒ n i n ɒ ɒ
ŋɛ̀nɔ̀nɔ́	ŋ ɛ n ɒ n ɒ
ŋɛ̀nɛ̀	ŋ ɛ n ɛ
ŋɛ̀nɛ́ðà	ŋ ɛ n ɛ ð ɑ
ŋɛ̀rá	ŋ ɛ ɹ ɑ
ŋɛ̀râ	ŋ ɛ ɹ ɑ
ŋɛ̀rdɛ̀cí	ŋ ɛ ɹ d ɛ tʃ i
ŋɛ̀rəɛcít̪ólèɲanoŋɛvdɛ	ŋ ɛ ɹ ə ɛ tʃ i t ow l ɛ ɲ ɑ n ow ŋ ɛ v d ɛ
ŋɛ̀rɛ́	ŋ ɛ ɹ ɛ
ŋɛ̀vɛ̀r	ŋ ɛ v ɛ ɹ
ŋɛ̀ðìnì	ŋ ɛ ð i n i
ŋɛ̀ðìní	ŋ ɛ ð i n i
ŋɛ̀ðìnɔ̀	ŋ ɛ ð i n ɒ
ŋɛ̀ðìnɔ́	ŋ ɛ ð i n ɒ
ŋɛ̀ŋcíŋì	ŋ ɛ ŋ tʃ i ŋ i
ŋɛ̀ŋɔ̀nɔ́	ŋ ɛ ŋ ɒ n ɒ
ŋɛ̀ŋɔ̀nɔ́l	ŋ ɛ ŋ ɒ n ɒ l
ŋɛ̀ŋɔ̀nɔ́nùjɛ́lɛ̀	ŋ ɛ ŋ ɒ n ɒ n ʉ j ɛ l ɛ
ŋɛ̀ɾǎ	ŋ ɛ ɾ ɑ
ŋɛ́	ŋ ɛ
ŋɛ́bɛ̀	ŋ ɛ b ɛ
ŋɛ́dì	ŋ ɛ d i
ŋɛ́dìì	ŋ ɛ d i i
ŋɛ́mbùɽù	ŋ ɛ m b ʉ ɹ ʉ
ŋɛ́n	ŋ ɛ n
ŋɛ́náò	ŋ ɛ n ɑ ow
ŋɛ́nê	ŋ ɛ n ɛ
ŋɛ́nì	ŋ ɛ n i
ŋɛ́nnê	ŋ ɛ n n ɛ
ŋɛ́nɔ̀nɔ́	ŋ ɛ n ɒ n ɒ
ŋɛ́nɛ	ŋ ɛ n ɛ
ŋɛ́nɛ̀	ŋ ɛ n ɛ
ŋɛ́nɛ̀pɔ̀n	ŋ ɛ n ɛ p ɒ n
ŋɛ́nɛ̀pɔ́n	ŋ ɛ n ɛ p ɒ n
ŋɛ́nɛ́	ŋ ɛ n ɛ
ŋɛ́nɛ̌	ŋ ɛ n ɛ
ŋɛ́rdɛ̀cì	ŋ ɛ ɹ d ɛ tʃ i
ŋɛ́rlɛ̀ŋí	ŋ ɛ ɹ l ɛ ŋ i
ŋɛ́rɛ́gɛ̀	ŋ ɛ ɹ ɛ ɡ ɛ
ŋɛ́rɛ́gɛ̌	ŋ ɛ ɹ ɛ ɡ ɛ
ŋɛ́t̪ì	ŋ ɛ t i
ŋɛ́və̀lɛ̀ðɛ̀	ŋ ɛ v ə l ɛ ð ɛ
ŋɛ́və́lɛ̂ðɛ̀	ŋ ɛ v ə l ɛ ð ɛ
ŋɛ́v̀lɛ̀ðɛ̀	ŋ ɛ v l ɛ ð ɛ
ŋɛ́ðìnɔ̀	ŋ ɛ ð i n ɒ
ŋɛ́ðìnɔ́	ŋ ɛ ð i n ɒ
ŋɛ́ðùɽár	ŋ ɛ ð ʉ ɹ ɑ ɹ
ŋɛ́ð̀àŋàl	ŋ ɛ ð ɑ ŋ ɑ l
ŋɛ́ŋàɲà	ŋ ɛ ŋ ɑ ɲ ɑ
ŋɛ́ŋgâɲà	ŋ ɛ ŋ ɡ ɑ ɲ ɑ
ŋɛ́ŋɛ̀	ŋ ɛ ŋ ɛ
ŋɛ́ɲ	ŋ ɛ ɲ
ŋɛ́ɲɛ̀	ŋ ɛ ɲ ɛ
ŋɛ́ɲɛ́	ŋ ɛ ɲ ɛ
ŋɛ́ɽðà	ŋ ɛ ɹ ð ɑ
ŋɛ́ɽðì	ŋ ɛ ɹ ð i
ŋɛ́ɽɛ̀ðè	ŋ ɛ ɹ ɛ ð ɛ
ŋɛ́ɾɛ́	ŋ ɛ ɾ ɛ
ŋɛ̂n	ŋ ɛ n
ŋɛ̂ðə̀ŋnánó	ŋ ɛ ð ə ŋ n ɑ n ow
ŋɛ̌	ŋ ɛ
ŋɛ̌n	ŋ ɛ n
ŋɜ̀ðɜ̀ŋnɔ́	ŋ ɐ ð ɐ ŋ n ɒ
ŋɜ́dì	ŋ ɐ d i
ŋɜ́t̪ú	ŋ ɐ t ʉ
ŋɽɔ̀mɛ̀	ŋ ɹ ɒ m ɛ
ŋɾâǔ	ŋ ɾ ɑ ʉ
ŋɾɛ́	ŋ ɾ ɛ
ŋʊ̀clò	ŋ ʊ tʃ l ow
ŋʊ̀cɔ̀	ŋ ʊ tʃ ɒ
ŋʊ̀dɔ́	ŋ ʊ d ɒ
ŋʊ̀lgɛ̀	ŋ ʊ l ɡ ɛ
ŋʊ̀mbòɽò	ŋ ʊ m b ow ɹ ow
ŋʊ̀mbòɽó	ŋ ʊ m b ow ɹ ow
ŋʊ̀mbə́ɽó	ŋ ʊ m b ə ɹ ow
ŋʊ̀mút̪ɔ̀	ŋ ʊ m ʉ t ɒ
ŋʊ̀mút̪ɛ̀	ŋ ʊ m ʉ t ɛ
ŋʊ̀rɔ́t̪ɛ̌	ŋ ʊ ɹ ɒ t ɛ
ŋʊ̀tòsà	ŋ ʊ t ow s ɑ
ŋʊ̀tòsò	ŋ ʊ t ow s ow
ŋʊ̀tù	ŋ ʊ t ʉ
ŋʊ̀tú	ŋ ʊ t ʉ
ŋʊ̀t̪òlìŋà	ŋ ʊ t ow l i ŋ ɑ
ŋʊ́dɔ́	ŋ ʊ d ɒ
ŋʊ́dʊ́	ŋ ʊ d ʊ
ŋʊ́mbɛ́	ŋ ʊ m b ɛ
ŋʊ́núbà	ŋ ʊ n ʉ b ɑ
ŋʊ́t̪òlíŋà	ŋ ʊ t ow l i ŋ ɑ
ŋʊ́t̪òlíŋá	ŋ ʊ t ow l i ŋ ɑ
ŋʊ́t̪òlíŋâ	ŋ ʊ t ow l i ŋ ɑ
ŋ̀	ŋ
ŋ̀cɔ́	ŋ tʃ ɒ
ŋ̀cɔ́lɔ̀	ŋ tʃ ɒ l ɒ
ŋ̀cɔ́lɔ́	ŋ tʃ ɒ l ɒ
ŋ̀cə̀lú	ŋ tʃ ə l ʉ
ŋ̀c̀lò	ŋ tʃ l ow
ŋ̀c̀ló	ŋ tʃ l ow
ŋ̀dúrì	ŋ d ʉ ɹ i
ŋ̀dúrɔ̀	ŋ d ʉ ɹ ɒ
ŋ̀d̪òbá	ŋ d ow b ɑ
ŋ̀gà	ŋ ɡ ɑ
ŋ̀gàlvə́lɛ̂ðɛ̀	ŋ ɡ ɑ l v ə l ɛ ð ɛ
ŋ̀gàlvə́lɛ̂ðɛ̌r	ŋ ɡ ɑ l v ə l ɛ ð ɛ ɹ
ŋ̀gàrɔ̀gɛ́	ŋ ɡ ɑ ɹ ɒ ɡ ɛ
ŋ̀gàvə́lɛ̂ðɛ̀	ŋ ɡ ɑ v ə l ɛ ð ɛ
ŋ̀gàvə́lɛ̂ðɛ̌	ŋ ɡ ɑ v ə l ɛ ð ɛ
ŋ̀gàŋvə́lɛ̂ðɛ̀	ŋ ɡ ɑ ŋ v ə l ɛ ð ɛ
ŋ̀gàŋvə́lɛ̂ðɛ̌	ŋ ɡ ɑ ŋ v ə l ɛ ð ɛ
ŋ̀gàɾcí	ŋ ɡ ɑ ɾ tʃ i
ŋ̀gádíjɜ̀	ŋ ɡ ɑ d i j ɐ
ŋ̀gádúrǒ	ŋ ɡ ɑ d ʉ ɹ ow
ŋ̀gád̪úrò	ŋ ɡ ɑ d ʉ ɹ ow
ŋ̀gád̪úrǒ	ŋ ɡ ɑ d ʉ ɹ ow
ŋ̀gágéɲà	ŋ ɡ ɑ ɡ ɛ ɲ ɑ
ŋ̀gágéɲǎ	ŋ ɡ ɑ ɡ ɛ ɲ ɑ
ŋ̀gáíjà	ŋ ɡ ɑ i j ɑ
ŋ̀gánɔ̂nà	ŋ ɡ ɑ n ɒ n ɑ
ŋ̀gátɛ́və́lɛ̂ðɔ́	ŋ ɡ ɑ t ɛ v ə l ɛ ð ɒ
ŋ̀gátɛ́və́lɛ̂ðɔ́r	ŋ ɡ ɑ t ɛ v ə l ɛ ð ɒ ɹ
ŋ̀gávə́lɛ̂ðɛ̀	ŋ ɡ ɑ v ə l ɛ ð ɛ
ŋ̀gávə́lɛ̂ðɛ̌	ŋ ɡ ɑ v ə l ɛ ð ɛ
ŋ̀gáðə́rɔ̂ðà	ŋ ɡ ɑ ð ə ɹ ɒ ð ɑ
ŋ̀gáɽíɲînɔ̀	ŋ ɡ ɑ ɹ i ɲ i n ɒ
ŋ̀gáɽíɲînɔ̌	ŋ ɡ ɑ ɹ i ɲ i n ɒ
ŋ̀gáɾà	ŋ ɡ ɑ ɾ ɑ
ŋ̀gáɾì	ŋ ɡ ɑ ɾ i
ŋ̀gáɾɔ́ðà	ŋ ɡ ɑ ɾ ɒ ð ɑ
ŋ̀gáɾɔ́ðàt̪à	ŋ ɡ ɑ ɾ ɒ ð ɑ t ɑ
ŋ̀gáɾɔ́ðìt̪ɔ̀	ŋ ɡ ɑ ɾ ɒ ð i t ɒ
ŋ̀gâlvə̀lɛ̀ðó	ŋ ɡ ɑ l v ə l ɛ ð ow
ŋ̀gâvlɛ̀ðɔ̀	ŋ ɡ ɑ v l ɛ ð ɒ
ŋ̀gâvlɛ̀ðɔ́	ŋ ɡ ɑ v l ɛ ð ɒ
ŋ̀gǎdíjà	ŋ ɡ ɑ d i j ɑ
ŋ̀gǎdíjɜ̀	ŋ ɡ ɑ d i j ɐ
ŋ̀gǎjéðà	ŋ ɡ ɑ j ɛ ð ɑ
ŋ̀gǎl	ŋ ɡ ɑ l
ŋ̀gǎlə́ŋàt̪à	ŋ ɡ ɑ l ə ŋ ɑ t ɑ
ŋ̀gǎvə́lɛ̂ðà	ŋ ɡ ɑ v ə l ɛ ð ɑ
ŋ̀gǎŋîí	ŋ ɡ ɑ ŋ i i
ŋ̀gǎŋîvlɛ̀ðɔ́	ŋ ɡ ɑ ŋ i v l ɛ ð ɒ
ŋ̀gǎ̀lvə̀lɛ̀ðɛ̀	ŋ ɡ ɑ l v ə l ɛ ð ɛ
ŋ̀géɲárvə́lɛ̂ðɔ́	ŋ ɡ ɛ ɲ ɑ ɹ v ə l ɛ ð ɒ
ŋ̀géɲávlɛ̂ðɔ́	ŋ ɡ ɛ ɲ ɑ v l ɛ ð ɒ
ŋ̀gěɲàgɛ̀rɛ́	ŋ ɡ ɛ ɲ ɑ ɡ ɛ ɹ ɛ
ŋ̀gěɲàgɛ́	ŋ ɡ ɛ ɲ ɑ ɡ ɛ
ŋ̀gíðɔ̀	ŋ ɡ i ð ɒ
ŋ̀gíðɛ̀	ŋ ɡ i ð ɛ
ŋ̀gíɲárvə́lɛ̂ðɔ́	ŋ ɡ i ɲ ɑ ɹ v ə l ɛ ð ɒ
ŋ̀gòó	ŋ ɡ ow ow
ŋ̀gó	ŋ ɡ ow
ŋ̀gɛ̀və́lɛ̂ðɛ̀	ŋ ɡ ɛ v ə l ɛ ð ɛ
ŋ̀gɛ̀və́lɛ̂ðɛ̌	ŋ ɡ ɛ v ə l ɛ ð ɛ
ŋ̀gɛ̀ɲávə́lɛ̂ðɛ̀	ŋ ɡ ɛ ɲ ɑ v ə l ɛ ð ɛ
ŋ̀gɛ́lǎ	ŋ ɡ ɛ l ɑ
ŋ̀gɛ́vəlɛ̂ðɔ́	ŋ ɡ ɛ v ə l ɛ ð ɒ
ŋ̀gɛ̌ɲâvə̀lɛ̀ðɛ̀	ŋ ɡ ɛ ɲ ɑ v ə l ɛ ð ɛ
ŋ̀gɜ́pínò	ŋ ɡ ɐ p i n ow
ŋ̀ívdɛ̀cɔ̀	ŋ i v d ɛ tʃ ɒ
ŋ̀kíðɛ̀	ŋ k i ð ɛ
ŋ̀kɔ́t̪ɛ̀	ŋ k ɒ t ɛ
ŋ̀lɔ́ɽà	ŋ l ɒ ɹ ɑ
ŋ̀lɔ́ɽɛ̀	ŋ l ɒ ɹ ɛ
ŋ̀maɛ́ðɛ̀nɛ	ŋ m ɑ ɛ ð ɛ n ɛ
ŋ̀mɔ́ð	ŋ m ɒ ð
ŋ̀mɛ́ðɛ̀	ŋ m ɛ ð ɛ
ŋ̀mɽàɾɛ̀	ŋ m ɹ ɑ ɾ ɛ
ŋ̀ndì	ŋ n d i
ŋ̀nùbà	ŋ n ʉ b ɑ
ŋ̀rím	ŋ ɹ i m
ŋ̀rímɛ̀	ŋ ɹ i m ɛ
ŋ̀rɔ́bà	ŋ ɹ ɒ b ɑ
ŋ̀rɔ́t̪ɛ̀	ŋ ɹ ɒ t ɛ
ŋ̀rɔ́t̪ɛ̌	ŋ ɹ ɒ t ɛ
ŋ̀rɛ́	ŋ ɹ ɛ
ŋ̀tá	ŋ t ɑ
ŋ̀tɾì	ŋ t ɾ i
ŋ̀wt̪út̪ú	ŋ w t ʉ t ʉ
ŋ̀ðèní	ŋ ð ɛ n i
ŋ̀ðìní	ŋ ð i n i
ŋ̀ðə̀ní	ŋ ð ə n i
ŋ̀ðə̀ŋnánó	ŋ ð ə ŋ n ɑ n ow
ŋ̀ðɛ̀ní	ŋ ð ɛ n i
ŋ̀ð̀ní	ŋ ð n i
ŋ̀ŋɔ́ŋà	ŋ ŋ ɒ ŋ ɑ
ŋ̀ŋɔ́ŋɛ̌	ŋ ŋ ɒ ŋ ɛ
ŋ̀ɽá	ŋ ɹ ɑ
ŋ̀ɽòmé	ŋ ɹ ow m ɛ
ŋ́cɔ́lɔ̀	ŋ tʃ ɒ l ɒ
ŋ́gàràt̪ɔ́l	ŋ ɡ ɑ ɹ ɑ t ɒ l
ŋ́gàrɔ́gɛ́	ŋ ɡ ɑ ɹ ɒ ɡ ɛ
ŋ́gárɔ́ðà	ŋ ɡ ɑ ɹ ɒ ð ɑ
ŋ́gávə̀lɛ̀ðɔ́	ŋ ɡ ɑ v ə l ɛ ð ɒ
ŋ́gúɽì	ŋ ɡ ʉ ɹ i
ŋ́írdɛ̀cì	ŋ i ɹ d ɛ tʃ i
ŋ́lídì	ŋ l i d i
ŋ́núbà	ŋ n ʉ b ɑ
ŋ́rɔ́mɔ̀	ŋ ɹ ɒ m ɒ
ŋ́rɔ́mɔ̌	ŋ ɹ ɒ m ɒ
ŋ́və́lɛ̀ðɛ̀	ŋ v ə l ɛ ð ɛ
ŋ́ŋ́t̪ɔ̀nɔ̀	ŋ ŋ t ɒ n ɒ
ŋ́ɛ̂	ŋ ɛ
ŋ́ɛ̂n	ŋ ɛ n
ŋ̌	ŋ
ɔárt̪ɔ̀	ɒ ɑ ɹ t ɒ
ɔɟɔŋo	ɒ dʒ ɒ ŋ ow
ɔɾa	ɒ ɾ ɑ
ɔ̀bðà	ɒ b ð ɑ
ɔ̀bðá	ɒ b ð ɑ
ɔ̀bðí	ɒ b ð i
ɔ̀dá	ɒ d ɑ
ɔ̀dɔ́	ɒ d ɒ
ɔ̀d̪a	ɒ d ɑ
ɔ̀j	ɒ j
ɔ̀mì	ɒ m i
ɔ̀mná	ɒ m n ɑ
ɔ̀mnâ	ɒ m n ɑ
ɔ̀mnɛ̀ð	ɒ m n ɛ ð
ɔ̀mnɛ́	ɒ m n ɛ
ɔ̀ndi	ɒ n d i
ɔ̀ndì	ɒ n d i
ɔ̀nì	ɒ n i
ɔ̀pí	ɒ p i
ɔ̀rà	ɒ ɹ ɑ
ɔ̀ràlì	ɒ ɹ ɑ l i
ɔ̀ràlí	ɒ ɹ ɑ l i
ɔ̀ràlír	ɒ ɹ ɑ l i ɹ
ɔ̀ràt̪ɛ̀	ɒ ɹ ɑ t ɛ
ɔ̀ráí	ɒ ɹ ɑ i
ɔ̀ráj	ɒ ɹ ɑ j
ɔ̀rí	ɒ ɹ i
ɔ̀rt̪ɔ́	ɒ ɹ t ɒ
ɔ̀tɔ́ðɛ́	ɒ t ɒ ð ɛ
ɔ̀ðíjɛ	ɒ ð i j ɛ
ɔ̀ðɔ̀ŋìnà	ɒ ð ɒ ŋ i n ɑ
ɔ̀ðə̀ŋìnà	ɒ ð ə ŋ i n ɑ
ɔ̀ðə̀ŋìnǎ	ɒ ð ə ŋ i n ɑ
ɔ̀ðə̀ŋ̀ní	ɒ ð ə ŋ n i
ɔ̀ðɛ̀ŋìnà	ɒ ð ɛ ŋ i n ɑ
ɔ̀ŋɔ̀ŋnɔ́	ɒ ŋ ɒ ŋ n ɒ
ɔ̀ɔ̀ɾò	ɒ ɒ ɾ ow
ɔ̀ɟɔ̀	ɒ dʒ ɒ
ɔ̀ɟɔ́	ɒ dʒ ɒ
ɔ̀ɟɔ́ŋrɛ̀	ɒ dʒ ɒ ŋ ɹ ɛ
ɔ̀ɟɔ́ŋrɛ́	ɒ dʒ ɒ ŋ ɹ ɛ
ɔ̀ɽàt̪à	ɒ ɹ ɑ t ɑ
ɔ̀ɽàt̪ɛ̀	ɒ ɹ ɑ t ɛ
ɔ̀ɽá	ɒ ɹ ɑ
ɔ̀ɽcàcá	ɒ ɹ tʃ ɑ tʃ ɑ
ɔ̀ɽcàciðijɔ̀	ɒ ɹ tʃ ɑ tʃ i ð i j ɒ
ɔ̀ɽcàciðìjí	ɒ ɹ tʃ ɑ tʃ i ð i j i
ɔ̀ɽcàcìt̪ɔ́	ɒ ɹ tʃ ɑ tʃ i t ɒ
ɔ̀ɽcàcìðìjìt̪ɔ̀	ɒ ɹ tʃ ɑ tʃ i ð i j i t ɒ
ɔ̀ɽcàcìðìt̪ɔ́	ɒ ɹ tʃ ɑ tʃ i ð i t ɒ
ɔ̀ɽcàcìðí	ɒ ɹ tʃ ɑ tʃ i ð i
ɔ̀ɽcàcí	ɒ ɹ tʃ ɑ tʃ i
ɔ̀ɽcàcíðìt̪ɔ́	ɒ ɹ tʃ ɑ tʃ i ð i t ɒ
ɔ̀ɽcâ	ɒ ɹ tʃ ɑ
ɔ̀ɽìt̪ɔ̀	ɒ ɹ i t ɒ
ɔ̀ɽìt̪ɛ̀	ɒ ɹ i t ɛ
ɔ̀ɽɟàcìjí	ɒ ɹ dʒ ɑ tʃ i j i
ɔ̀ɽɟɔ̀cɔ̀nɔ́	ɒ ɹ dʒ ɒ tʃ ɒ n ɒ
ɔ̀ɽɟɛ̀cà	ɒ ɹ dʒ ɛ tʃ ɑ
ɔ̀ɽɟɛ̀cì	ɒ ɹ dʒ ɛ tʃ i
ɔ̀ɽɟɛ̀cí	ɒ ɹ dʒ ɛ tʃ i
ɔ̀ɽɟɛ̀cɔ̀nɔ̀	ɒ ɹ dʒ ɛ tʃ ɒ n ɒ
ɔ̀ɽɟɛ̀cɔ̀nɔ́	ɒ ɹ dʒ ɛ tʃ ɒ n ɒ
ɔ̀ɽɟɛ̀n	ɒ ɹ dʒ ɛ n
ɔ̀ɽɟɛ́cá	ɒ ɹ dʒ ɛ tʃ ɑ
ɔ̀ɽɟɛ̌n	ɒ ɹ dʒ ɛ n
ɔ̀ɾà	ɒ ɾ ɑ
ɔ̀ɾàgícɔ̀	ɒ ɾ ɑ ɡ i tʃ ɒ
ɔ̀ɾàí	ɒ ɾ ɑ i
ɔ̀ɾàlí	ɒ ɾ ɑ l i
ɔ̀ɾàlír	ɒ ɾ ɑ l i ɹ
ɔ̀ɾàló	ɒ ɾ ɑ l ow
ɔ̀ɾá	ɒ ɾ ɑ
ɔ̀ɾì	ɒ ɾ i
ɔ́	ɒ
ɔ́bəðɔ́	ɒ b ə ð ɒ
ɔ́dà	ɒ d ɑ
ɔ́dǎ	ɒ d ɑ
ɔ́dɔ̀	ɒ d ɒ
ɔ́dɔ́	ɒ d ɒ
ɔ́j	ɒ j
ɔ́là	ɒ l ɑ
ɔ́lá	ɒ l ɑ
ɔ́lt̪kɔ́t̪ɛ̀	ɒ l t k ɒ t ɛ
ɔ́ndè	ɒ n d ɛ
ɔ́ndi	ɒ n d i
ɔ́ndì	ɒ n d i
ɔ́ndí	ɒ n d i
ɔ́ndǐ	ɒ n d i
ɔ́nì	ɒ n i
ɔ́ní	ɒ n i
ɔ́níðú	ɒ n i ð ʉ
ɔ́níðúr	ɒ n i ð ʉ ɹ
ɔ́nt̪ɔ̀	ɒ n t ɒ
ɔ́rà	ɒ ɹ ɑ
ɔ́rá	ɒ ɹ ɑ
ɔ́ráj	ɒ ɹ ɑ j
ɔ́rn	ɒ ɹ n
ɔ́rnd̪ɔ̀bà	ɒ ɹ n d ɒ b ɑ
ɔ́rtɔ̀	ɒ ɹ t ɒ
ɔ́rt̪ɔ̀	ɒ ɹ t ɒ
ɔ́rɔ́ðɛ̀	ɒ ɹ ɒ ð ɛ
ɔ́rɔ̂ð	ɒ ɹ ɒ ð
ɔ́rɛ́	ɒ ɹ ɛ
ɔ́ðà	ɒ ð ɑ
ɔ́ðə̀ŋìnà	ɒ ð ə ŋ i n ɑ
ɔ́ðə̀ŋìnǎ	ɒ ð ə ŋ i n ɑ
ɔ́ŋɔ̀r	ɒ ŋ ɒ ɹ
ɔ́ŋɔ̀ŋnɔ̀	ɒ ŋ ɒ ŋ n ɒ
ɔ́ŋɔ̀ŋnɔ́	ɒ ŋ ɒ ŋ n ɒ
ɔ́ŋɔ́r	ɒ ŋ ɒ ɹ
ɔ́ŋɔ́ŋnɔ́	ɒ ŋ ɒ ŋ n ɒ
ɔ́ɟɔ	ɒ dʒ ɒ
ɔ́ɟɔ̀	ɒ dʒ ɒ
ɔ́ɟɔ́	ɒ dʒ ɒ
ɔ́ɟɔ́ŋ	ɒ dʒ ɒ ŋ
ɔ́ɟɔ́ŋà	ɒ dʒ ɒ ŋ ɑ
ɔ́ɟɔ́ŋàǎ	ɒ dʒ ɒ ŋ ɑ ɑ
ɔ́ɟɔ́ŋá	ɒ dʒ ɒ ŋ ɑ
ɔ́ɟɔ́ŋǎ	ɒ dʒ ɒ ŋ ɑ
ɔ́ɟɔ̂	ɒ dʒ ɒ
ɔ́ɟɔ̂ŋ	ɒ dʒ ɒ ŋ
ɔ́ɟɔ̂ŋù	ɒ dʒ ɒ ŋ ʉ
ɔ́ɽcàcà	ɒ ɹ tʃ ɑ tʃ ɑ
ɔ́ɽcàcijɔ̀	ɒ ɹ tʃ ɑ tʃ i j ɒ
ɔ́ɽcàciðìjɔ̀	ɒ ɹ tʃ ɑ tʃ i ð i j ɒ
ɔ́ɽcàcìðà	ɒ ɹ tʃ ɑ tʃ i ð ɑ
ɔ́ɽcàcìðìjìt̪ɔ̀	ɒ ɹ tʃ ɑ tʃ i ð i j i t ɒ
ɔ́ɽcàcìðìt̪ɔ̀	ɒ ɹ tʃ ɑ tʃ i ð i t ɒ
ɔ́ɽcàcíðìjìt̪ɔ̀	ɒ ɹ tʃ ɑ tʃ i ð i j i t ɒ
ɔ́ɽcàcíðìjɔ̀	ɒ ɹ tʃ ɑ tʃ i ð i j ɒ
ɔ́ɽcácí	ɒ ɹ tʃ ɑ tʃ i
ɔ́ɽcì	ɒ ɹ tʃ i
ɔ́ɽɔ́	ɒ ɹ ɒ
ɔ́ɽɟàcijɔ̀	ɒ ɹ dʒ ɑ tʃ i j ɒ
ɔ́ɽɟɔ̀cɔ̀nɔ̀	ɒ ɹ dʒ ɒ tʃ ɒ n ɒ
ɔ́ɽɟɔ̀cɔ̀nɔ́	ɒ ɹ dʒ ɒ tʃ ɒ n ɒ
ɔ́ɽɟɔ̀cɔ̀ŋnɔ̀	ɒ ɹ dʒ ɒ tʃ ɒ ŋ n ɒ
ɔ́ɽɟɛ̀cà	ɒ ɹ dʒ ɛ tʃ ɑ
ɔ́ɽɟɛ̀cì	ɒ ɹ dʒ ɛ tʃ i
ɔ́ɽɟɛ̀cí	ɒ ɹ dʒ ɛ tʃ i
ɔ́ɽɟɛ̀cíŋì	ɒ ɹ dʒ ɛ tʃ i ŋ i
ɔ́ɽɟɛ̀cɔ̀nɔ̀	ɒ ɹ dʒ ɛ tʃ ɒ n ɒ
ɔ́ɽɟɛ̀cɔ̀ŋnɔ̀	ɒ ɹ dʒ ɛ tʃ ɒ ŋ n ɒ
ɔ́ɽɟɛ́cí	ɒ ɹ dʒ ɛ tʃ i
ɔ́ɽɟɛ́nɛ́	ɒ ɹ dʒ ɛ n ɛ
ɔ́ɾà	ɒ ɾ ɑ
ɔ́ɾá	ɒ ɾ ɑ
ɔ́ɾíɲɛ́	ɒ ɾ i ɲ ɛ
ɔ́ɾɛ̀	ɒ ɾ ɛ
ɔ́ɾɛ́	ɒ ɾ ɛ
ɔ́ɾɛ̌	ɒ ɾ ɛ
ɔ̂dɔ̀ŋnɔ́	ɒ d ɒ ŋ n ɒ
ɔ̂nt̪ɔ́	ɒ n t ɒ
ɔ̂rnɔ̀	ɒ ɹ n ɒ
ɔ̂ɟɔ́	ɒ dʒ ɒ
ɔ̂ɟɔ́ŋrɛ́	ɒ dʒ ɒ ŋ ɹ ɛ
ɔ̂ɽɟɛ̀cà	ɒ ɹ dʒ ɛ tʃ ɑ
ɔ̂ɽɟɛ̀cí	ɒ ɹ dʒ ɛ tʃ i
ɔ̌j	ɒ j
ə	ə
əðəò	ə ð ə ow
ə̀ndrí	ə n d ɹ i
ə̀rdá	ə ɹ d ɑ
ə̀rlɔ̀ɲɔ́	ə ɹ l ɒ ɲ ɒ
ə̀ŋnà	ə ŋ n ɑ
ə̀ŋná	ə ŋ n ɑ
ə́rdɔ́	ə ɹ d ɒ
ə́rlɛ́ɲí	ə ɹ l ɛ ɲ i
ə́rðɔ́	ə ɹ ð ɒ
ɛ	ɛ
ɛlɔ	ɛ l ɒ
ɛmnà	ɛ m n ɑ
ɛrɔ́	ɛ ɹ ɒ
ɛɽɛ	ɛ ɹ ɛ
ɛɽɛ̀	ɛ ɹ ɛ
ɛɽɛ̌	ɛ ɹ ɛ
ɛɾaðɛ	ɛ ɾ ɑ ð ɛ
ɛ̀	ɛ
ɛ̀bàlú	ɛ b ɑ l ʉ
ɛ̀bɛ̀	ɛ b ɛ
ɛ̀bɛ̀í	ɛ b ɛ i
ɛ̀dí	ɛ d i
ɛ̀dɛ́ràló	ɛ d ɛ ɹ ɑ l ow
ɛ̀gáɾàt̪ɔ́	ɛ ɡ ɑ ɾ ɑ t ɒ
ɛ̀gɔ́	ɛ ɡ ɒ
ɛ̀jɔ́l	ɛ j ɒ l
ɛ̀l	ɛ l
ɛ̀là	ɛ l ɑ
ɛ̀làɽà	ɛ l ɑ ɹ ɑ
ɛ̀lá	ɛ l ɑ
ɛ̀ló	ɛ l ow
ɛ̀lɔ̀	ɛ l ɒ
ɛ̀lɔ́	ɛ l ɒ
ɛ̀lə̀ŋà	ɛ l ə ŋ ɑ
ɛ̀lɛ̀	ɛ l ɛ
ɛ̀lɛ̌	ɛ l ɛ
ɛ̀mànàlí	ɛ m ɑ n ɑ l i
ɛ̀mànàlír	ɛ m ɑ n ɑ l i ɹ
ɛ̀mànàló	ɛ m ɑ n ɑ l ow
ɛ̀mànàlʊ́	ɛ m ɑ n ɑ l ʊ
ɛ̀mànáj	ɛ m ɑ n ɑ j
ɛ̀mànɛ́n	ɛ m ɑ n ɛ n
ɛ̀màð	ɛ m ɑ ð
ɛ̀màðàlí	ɛ m ɑ ð ɑ l i
ɛ̀màðàlír	ɛ m ɑ ð ɑ l i ɹ
ɛ̀màðàlʊ́	ɛ m ɑ ð ɑ l ʊ
ɛ̀màðáj	ɛ m ɑ ð ɑ j
ɛ̀màðɛ̀	ɛ m ɑ ð ɛ
ɛ̀màðɛ̀lí	ɛ m ɑ ð ɛ l i
ɛ̀màðɛ̀lír	ɛ m ɑ ð ɛ l i ɹ
ɛ̀màðɛ́n	ɛ m ɑ ð ɛ n
ɛ̀màɾðɛ́n	ɛ m ɑ ɾ ð ɛ n
ɛ̀n	ɛ n
ɛ̀nì	ɛ n i
ɛ̀níŋí	ɛ n i ŋ i
ɛ̀ń	ɛ n
ɛ̀ré	ɛ ɹ ɛ
ɛ̀rlànd̪á	ɛ ɹ l ɑ n d ɑ
ɛ̀rlɛ̀nd̪ìt̪ɔ́	ɛ ɹ l ɛ n d i t ɒ
ɛ̀rə̀mt̪ɛ̀j	ɛ ɹ ə m t ɛ j
ɛ̀rə̀mt̪ɛ̀n	ɛ ɹ ə m t ɛ n
ɛ̀rə̀mt̪ɛ́j	ɛ ɹ ə m t ɛ j
ɛ̀rɛ̀ð	ɛ ɹ ɛ ð
ɛ̀rɛ́	ɛ ɹ ɛ
ɛ̀vàlá	ɛ v ɑ l ɑ
ɛ̀vàɾtɔ̀	ɛ v ɑ ɾ t ɒ
ɛ̀vàɾt̪à	ɛ v ɑ ɾ t ɑ
ɛ̀vlà	ɛ v l ɑ
ɛ̀vlá	ɛ v l ɑ
ɛ̀və̀là	ɛ v ə l ɑ
ɛ̀və́lɛ̀ðɛ̀	ɛ v ə l ɛ ð ɛ
ɛ̀vɛ̀	ɛ v ɛ
ɛ̀vɛ̌	ɛ v ɛ
ɛ̀ðà	ɛ ð ɑ
ɛ̀ðɔ̀ŋɔ̀	ɛ ð ɒ ŋ ɒ
ɛ̀ðɛ̀	ɛ ð ɛ
ɛ̀ðɛ̀ŋgàlí	ɛ ð ɛ ŋ ɡ ɑ l i
ɛ̀ðɛ̀ŋgàlír	ɛ ð ɛ ŋ ɡ ɑ l i ɹ
ɛ̀ðɛ̀ŋgàló	ɛ ð ɛ ŋ ɡ ɑ l ow
ɛ̀ðɛ̀ŋgàlʊ́	ɛ ð ɛ ŋ ɡ ɑ l ʊ
ɛ̀ðɛ̀ŋgɛ́j	ɛ ð ɛ ŋ ɡ ɛ j
ɛ̀ðɛ́	ɛ ð ɛ
ɛ̀ðɛ̌	ɛ ð ɛ
ɛ̀ŋàcíĺ	ɛ ŋ ɑ tʃ i l
ɛ̀ŋná	ɛ ŋ n ɑ
ɛ̀ɽðá	ɛ ɹ ð ɑ
ɛ̀ɽɛ̀	ɛ ɹ ɛ
ɛ̀ɽɛ́	ɛ ɹ ɛ
ɛ̀ɾáðɛ̀	ɛ ɾ ɑ ð ɛ
ɛ̀ɾáðɛ́	ɛ ɾ ɑ ð ɛ
ɛ̀ɾâð	ɛ ɾ ɑ ð
ɛ̀ɾə̀mt̪àlú	ɛ ɾ ə m t ɑ l ʉ
ɛ̀ɾə̀mt̪ù	ɛ ɾ ə m t ʉ
ɛ̀ɾə̀mt̪ɛ́j	ɛ ɾ ə m t ɛ j
ɛ̀ɾə̀mt̪ɛ́n	ɛ ɾ ə m t ɛ n
ɛ̀ɾɛ̀ð	ɛ ɾ ɛ ð
ɛ́	ɛ
ɛ́cílò	ɛ tʃ i l ow
ɛ́dárɛ́n	ɛ d ɑ ɹ ɛ n
ɛ́dɔ̀t̪ɔ́	ɛ d ɒ t ɒ
ɛ́dɛ́rɛ́n	ɛ d ɛ ɹ ɛ n
ɛ́gàí	ɛ ɡ ɑ i
ɛ́gàló	ɛ ɡ ɑ l ow
ɛ́gàɾǎ	ɛ ɡ ɑ ɾ ɑ
ɛ́gàɾɔ́	ɛ ɡ ɑ ɾ ɒ
ɛ́gái	ɛ ɡ ɑ i
ɛ́gáí	ɛ ɡ ɑ i
ɛ́gɔ́	ɛ ɡ ɒ
ɛ́gɛ́n	ɛ ɡ ɛ n
ɛ́l	ɛ l
ɛ́làrà	ɛ l ɑ ɹ ɑ
ɛ́làɽà	ɛ l ɑ ɹ ɑ
ɛ́làɾà	ɛ l ɑ ɾ ɑ
ɛ́lá	ɛ l ɑ
ɛ́lé	ɛ l ɛ
ɛ́léɲé	ɛ l ɛ ɲ ɛ
ɛ́léɲɛ́	ɛ l ɛ ɲ ɛ
ɛ́lê	ɛ l ɛ
ɛ́lò	ɛ l ow
ɛ́ló	ɛ l ow
ɛ́lɔ̀	ɛ l ɒ
ɛ́lɔ́	ɛ l ɒ
ɛ́lɔ́gɛ̌	ɛ l ɒ ɡ ɛ
ɛ́lɔ́ŋù	ɛ l ɒ ŋ ʉ
ɛ́lɔ̂	ɛ l ɒ
ɛ́lɔ̌	ɛ l ɒ
ɛ́lə̀ŋà	ɛ l ə ŋ ɑ
ɛ́lɛ́	ɛ l ɛ
ɛ́lɛ́n	ɛ l ɛ n
ɛ́lɲé	ɛ l ɲ ɛ
ɛ́n	ɛ n
ɛ́nà	ɛ n ɑ
ɛ́nàǎ	ɛ n ɑ ɑ
ɛ́ná	ɛ n ɑ
ɛ́ní	ɛ n i
ɛ́nɔ́	ɛ n ɒ
ɛ́nɛ̀n	ɛ n ɛ n
ɛ́nɛ́n	ɛ n ɛ n
ɛ́nɛ́nd̪rì	ɛ n ɛ n d ɹ i
ɛ́nɛ̂n	ɛ n ɛ n
ɛ́nɟi	ɛ n dʒ i
ɛ́rdɛ̀cì	ɛ ɹ d ɛ tʃ i
ɛ́rlánd̪ɔ́	ɛ ɹ l ɑ n d ɒ
ɛ́rlɛ́nd̪íjí	ɛ ɹ l ɛ n d i j i
ɛ́rlɛ́nd̪ít̪ɔ́	ɛ ɹ l ɛ n d i t ɒ
ɛ́rɔ́	ɛ ɹ ɒ
ɛ́rə̀lí	ɛ ɹ ə l i
ɛ́rə̀lír	ɛ ɹ ə l i ɹ
ɛ́rɛ̀ɲì	ɛ ɹ ɛ ɲ i
ɛ́rɛ̀ɲí	ɛ ɹ ɛ ɲ i
ɛ́rɛ́	ɛ ɹ ɛ
ɛ́rɛ́n	ɛ ɹ ɛ n
ɛ́tɛ́	ɛ t ɛ
ɛ́tɛ́və́lɛ̀ðɛ̀	ɛ t ɛ v ə l ɛ ð ɛ
ɛ́vàrt̪à	ɛ v ɑ ɹ t ɑ
ɛ́vàɾt̪à	ɛ v ɑ ɾ t ɑ
ɛ́vlà	ɛ v l ɑ
ɛ́və̀là	ɛ v ə l ɑ
ɛ́və́lɛ̀ðɛ̀	ɛ v ə l ɛ ð ɛ
ɛ́və́lɛ̂ðɛ̀	ɛ v ə l ɛ ð ɛ
ɛ́v́lɛ̀ðɛ̀	ɛ v l ɛ ð ɛ
ɛ́ðàí	ɛ ð ɑ i
ɛ́ðàló	ɛ ð ɑ l ow
ɛ́ðáj	ɛ ð ɑ j
ɛ́ðó	ɛ ð ow
ɛ́ðɔ́	ɛ ð ɒ
ɛ́ðɛ̀	ɛ ð ɛ
ɛ́ðɛ̀ŋí	ɛ ð ɛ ŋ i
ɛ́ðɛ̀ɲí	ɛ ð ɛ ɲ i
ɛ́ðɛ́	ɛ ð ɛ
ɛ́ðɛ́n	ɛ ð ɛ n
ɛ́ðɛ̌	ɛ ð ɛ
ɛ́ŋgárɛ́	ɛ ŋ ɡ ɑ ɹ ɛ
ɛ́ŋnà	ɛ ŋ n ɑ
ɛ́ŋná	ɛ ŋ n ɑ
ɛ́ŋə̀nà	ɛ ŋ ə n ɑ
ɛ́ŋə̀nàǎ	ɛ ŋ ə n ɑ ɑ
ɛ́ɲí	ɛ ɲ i
ɛ́ɽdɛ̀	ɛ ɹ d ɛ
ɛ́ɽðó	ɛ ɹ ð ow
ɛ́ɽɛ̀	ɛ ɹ ɛ
ɛ́ɽɛ́	ɛ ɹ ɛ
ɛ́ɾá	ɛ ɾ ɑ
ɛ́ɾâ	ɛ ɾ ɑ
ɛ́ɾɔ̀ðɔ̀	ɛ ɾ ɒ ð ɒ
ɛ́ɾɛ̀	ɛ ɾ ɛ
ɛ́ɾɛ́	ɛ ɾ ɛ
ɛ́̀ɽɛ̀	ɛ ɹ ɛ
ɛ̂ð	ɛ ð
ɜit̪o	ɐ i t ow
ɜító	ɐ i t ow
ɜ̀dí	ɐ d i
ɜ̀n	ɐ n
ɜ̀nì	ɐ n i
ɜ̀níŋí	ɐ n i ŋ i
ɜ̀nŋí	ɐ n ŋ i
ɜ̀rt̪ìnɔ́	ɐ ɹ t i n ɒ
ɜ̀ùɾ	ɐ ʉ ɾ
ɜ̀ðìɲɛ̀n	ɐ ð i ɲ ɛ n
ɜ̀ðìɲɛ́n	ɐ ð i ɲ ɛ n
ɜ̀ðú	ɐ ð ʉ
ɜ̀ŋcì	ɐ ŋ tʃ i
ɜ̀ŋcí	ɐ ŋ tʃ i
ɜ̀ɽìðá	ɐ ɹ i ð ɑ
ɜ̀ɾt̪î	ɐ ɾ t i
ɜ́dì	ɐ d i
ɜ́dí	ɐ d i
ɜ́lpúɾó	ɐ l p ʉ ɾ ow
ɜ́ntɛ̀	ɐ n t ɛ
ɜ́rt̪ínɔ́	ɐ ɹ t i n ɒ
ɜ́rú	ɐ ɹ ʉ
ɜ́rʊ́	ɐ ɹ ʊ
ɜ́ðíɲɜ̀nɛ̀	ɐ ð i ɲ ɐ n ɛ
ɜ́ŋcí	ɐ ŋ tʃ i
ɜ́ɽíðú	ɐ ɹ i ð ʉ
ɜ́ɾt̪íŋì	ɐ ɾ t i ŋ i
ɜ́ɾt̪íɲáɾɛ́	ɐ ɾ t i ɲ ɑ ɾ ɛ
ɜ́ɾt̪î	ɐ ɾ t i
ɜ́ɾú	ɐ ɾ ʉ
ɜ́ɾʊ́	ɐ ɾ ʊ
ɜ̂dí	ɐ d i
ɟàtà	dʒ ɑ t ɑ
ɟâ	dʒ ɑ
ɟìðɔ̀cɔ́	dʒ i ð ɒ tʃ ɒ
ɟígrə̀mnǎ	dʒ i ɡ ɹ ə m n ɑ
ɟíðɜ́cí	dʒ i ð ɐ tʃ i
ɟɛ̀n	dʒ ɛ n
ɲà	ɲ ɑ
ɲàbðó	ɲ ɑ b ð ow
ɲàbðɔ́	ɲ ɑ b ð ɒ
ɲàbə̀ðɔ́	ɲ ɑ b ə ð ɒ
ɲàcìlò	ɲ ɑ tʃ i l ow
ɲàcìlǒ	ɲ ɑ tʃ i l ow
ɲàd̪ùrɔ̀t̪ɔ́	ɲ ɑ d ʉ ɹ ɒ t ɒ
ɲàd̪ùrɔ́	ɲ ɑ d ʉ ɹ ɒ
ɲàgàró	ɲ ɑ ɡ ɑ ɹ ow
ɲàjá	ɲ ɑ j ɑ
ɲàját̪à	ɲ ɑ j ɑ t ɑ
ɲàját̪ìðà	ɲ ɑ j ɑ t i ð ɑ
ɲàjáðàt̪à	ɲ ɑ j ɑ ð ɑ t ɑ
ɲàjɔ́	ɲ ɑ j ɒ
ɲàjɛ́ðà	ɲ ɑ j ɛ ð ɑ
ɲàlàðɛ́gàɾà	ɲ ɑ l ɑ ð ɛ ɡ ɑ ɾ ɑ
ɲàlàðɛ́gâɾà	ɲ ɑ l ɑ ð ɛ ɡ ɑ ɾ ɑ
ɲàlágârà	ɲ ɑ l ɑ ɡ ɑ ɹ ɑ
ɲàlágârá	ɲ ɑ l ɑ ɡ ɑ ɹ ɑ
ɲàlárɔ́ðà	ɲ ɑ l ɑ ɹ ɒ ð ɑ
ɲàlátɛ́	ɲ ɑ l ɑ t ɛ
ɲàlátɛ́və́lɛ̂ðà	ɲ ɑ l ɑ t ɛ v ə l ɛ ð ɑ
ɲàlátɛ́və́lɛ̂ðǎ	ɲ ɑ l ɑ t ɛ v ə l ɛ ð ɑ
ɲàlátɛ́və́lɛ̂ðɛ̀	ɲ ɑ l ɑ t ɛ v ə l ɛ ð ɛ
ɲàlávə́lɛ̂ðɛ̀	ɲ ɑ l ɑ v ə l ɛ ð ɛ
ɲàlávə́lɛ̂ðɛ̌	ɲ ɑ l ɑ v ə l ɛ ð ɛ
ɲàláðə́gârà	ɲ ɑ l ɑ ð ə ɡ ɑ ɹ ɑ
ɲàláðə́gârá	ɲ ɑ l ɑ ð ə ɡ ɑ ɹ ɑ
ɲàláðɛ́là	ɲ ɑ l ɑ ð ɛ l ɑ
ɲàláðɛ́lǎ	ɲ ɑ l ɑ ð ɛ l ɑ
ɲàláŋâvlɛ̀dɔ́	ɲ ɑ l ɑ ŋ ɑ v l ɛ d ɒ
ɲàláŋâvlɛ̀ðɛ̀	ɲ ɑ l ɑ ŋ ɑ v l ɛ ð ɛ
ɲàláŋâvə̀lɛ̀ðɛ̀	ɲ ɑ l ɑ ŋ ɑ v ə l ɛ ð ɛ
ɲàláɽə̀ŋàt̪à	ɲ ɑ l ɑ ɹ ə ŋ ɑ t ɑ
ɲàláɽə̀ŋàt̪ǎ	ɲ ɑ l ɑ ɹ ə ŋ ɑ t ɑ
ɲàláɽə́ŋàt̪à	ɲ ɑ l ɑ ɹ ə ŋ ɑ t ɑ
ɲàláɽə́ŋàt̪ǎ	ɲ ɑ l ɑ ɹ ə ŋ ɑ t ɑ
ɲàlâvə̀lɛ̀ðɔ́	ɲ ɑ l ɑ v ə l ɛ ð ɒ
ɲàllárɔ́	ɲ ɑ l l ɑ ɹ ɒ
ɲàllé	ɲ ɑ l l ɛ
ɲàllów	ɲ ɑ l l ow w
ɲàlɛ́là	ɲ ɑ l ɛ l ɑ
ɲàlɛ́lǎ	ɲ ɑ l ɛ l ɑ
ɲàlɜ́ó	ɲ ɑ l ɐ ow
ɲàrì	ɲ ɑ ɹ i
ɲàrǐ	ɲ ɑ ɹ i
ɲàrɔ̀ðɔ̀	ɲ ɑ ɹ ɒ ð ɒ
ɲàrɔ́	ɲ ɑ ɹ ɒ
ɲàtɛ́	ɲ ɑ t ɛ
ɲàvé	ɲ ɑ v ɛ
ɲàvə̀lɛ̀ðà	ɲ ɑ v ə l ɛ ð ɑ
ɲàvə̀lɛ̀ðátɛ́	ɲ ɑ v ə l ɛ ð ɑ t ɛ
ɲàvə̀lɛ̀ðáŋà	ɲ ɑ v ə l ɛ ð ɑ ŋ ɑ
ɲàvə̀lɛ̀ðɛ̀	ɲ ɑ v ə l ɛ ð ɛ
ɲàŋ	ɲ ɑ ŋ
ɲàŋgú	ɲ ɑ ŋ ɡ ʉ
ɲàŋìðàt̪ɔ́	ɲ ɑ ŋ i ð ɑ t ɒ
ɲàŋìðú	ɲ ɑ ŋ i ð ʉ
ɲàŋt̪ìðú	ɲ ɑ ŋ t i ð ʉ
ɲàŋt̪ɔ́	ɲ ɑ ŋ t ɒ
ɲàŋú	ɲ ɑ ŋ ʉ
ɲàɽíŋgɔ̀	ɲ ɑ ɹ i ŋ ɡ ɒ
ɲàɽíŋgɔ́	ɲ ɑ ɹ i ŋ ɡ ɒ
ɲàɽə̀ŋàt̪ǒ	ɲ ɑ ɹ ə ŋ ɑ t ow
ɲá	ɲ ɑ
ɲácìló	ɲ ɑ tʃ i l ow
ɲágàró	ɲ ɑ ɡ ɑ ɹ ow
ɲágɔ̀bðí	ɲ ɑ ɡ ɒ b ð i
ɲágɛ́	ɲ ɑ ɡ ɛ
ɲájàt̪ìðú	ɲ ɑ j ɑ t i ð ʉ
ɲájàt̪ɔ́	ɲ ɑ j ɑ t ɒ
ɲájɔ́	ɲ ɑ j ɒ
ɲájɛ̀ðàðɔ́	ɲ ɑ j ɛ ð ɑ ð ɒ
ɲál	ɲ ɑ l
ɲálá	ɲ ɑ l ɑ
ɲálágârà	ɲ ɑ l ɑ ɡ ɑ ɹ ɑ
ɲálágârá	ɲ ɑ l ɑ ɡ ɑ ɹ ɑ
ɲálágâɾà	ɲ ɑ l ɑ ɡ ɑ ɾ ɑ
ɲálárɔ́ðà	ɲ ɑ l ɑ ɹ ɒ ð ɑ
ɲálárɛ́	ɲ ɑ l ɑ ɹ ɛ
ɲálátɛ́və́lɛ̂ðɛ̌r	ɲ ɑ l ɑ t ɛ v ə l ɛ ð ɛ ɹ
ɲálávə́lɛ̂ðɛ̀	ɲ ɑ l ɑ v ə l ɛ ð ɛ
ɲálávə́lɛ̂ðɛ̌	ɲ ɑ l ɑ v ə l ɛ ð ɛ
ɲáláðɛ́gâɾà	ɲ ɑ l ɑ ð ɛ ɡ ɑ ɾ ɑ
ɲáláðɛ́là	ɲ ɑ l ɑ ð ɛ l ɑ
ɲáláðɛ́lá	ɲ ɑ l ɑ ð ɛ l ɑ
ɲáláŋâá	ɲ ɑ l ɑ ŋ ɑ ɑ
ɲáláŋâvə̀lɛ̀ðà	ɲ ɑ l ɑ ŋ ɑ v ə l ɛ ð ɑ
ɲáláŋêvə̀lɛ̀ðà	ɲ ɑ l ɑ ŋ ɛ v ə l ɛ ð ɑ
ɲáláŋîvlɛ̀dɔ́	ɲ ɑ l ɑ ŋ i v l ɛ d ɒ
ɲáláŋîvə̀lɛ̀ðà	ɲ ɑ l ɑ ŋ i v ə l ɛ ð ɑ
ɲáláŋîvə̀lɛ̀ðɛ̀	ɲ ɑ l ɑ ŋ i v ə l ɛ ð ɛ
ɲáláɾɔ́ðà	ɲ ɑ l ɑ ɾ ɒ ð ɑ
ɲálâvə̀lɛ̀ðɔ́	ɲ ɑ l ɑ v ə l ɛ ð ɒ
ɲállárɔ́ðà	ɲ ɑ l l ɑ ɹ ɒ ð ɑ
ɲállów	ɲ ɑ l l ow w
ɲálɜ́ó	ɲ ɑ l ɐ ow
ɲár	ɲ ɑ ɹ
ɲárà	ɲ ɑ ɹ ɑ
ɲáré	ɲ ɑ ɹ ɛ
ɲárvə́lɛ̀ðà	ɲ ɑ ɹ v ə l ɛ ð ɑ
ɲárvə́lɛ̂ðà	ɲ ɑ ɹ v ə l ɛ ð ɑ
ɲárvə́lɛ̂ðǎ	ɲ ɑ ɹ v ə l ɛ ð ɑ
ɲárvə́lɛ̂ðɔ́	ɲ ɑ ɹ v ə l ɛ ð ɒ
ɲárvə́lɛ̂ðɛ̀	ɲ ɑ ɹ v ə l ɛ ð ɛ
ɲárɛ́	ɲ ɑ ɹ ɛ
ɲát̪ə́vìnɛ̀	ɲ ɑ t ə v i n ɛ
ɲát̪ə́vìnɛ̌	ɲ ɑ t ə v i n ɛ
ɲávé	ɲ ɑ v ɛ
ɲávə̀lɛ̀ðɔ́	ɲ ɑ v ə l ɛ ð ɒ
ɲávə̀lɛ̀ðɛ̀	ɲ ɑ v ə l ɛ ð ɛ
ɲávə̀lɛ̀ðɛ́ŋì	ɲ ɑ v ə l ɛ ð ɛ ŋ i
ɲávə̀lɛ̀ðɛ́ɲárɛ́	ɲ ɑ v ə l ɛ ð ɛ ɲ ɑ ɹ ɛ
ɲávə́lɛ̀ðà	ɲ ɑ v ə l ɛ ð ɑ
ɲávə́lɛ̀ðɛ̀	ɲ ɑ v ə l ɛ ð ɛ
ɲáŋâ	ɲ ɑ ŋ ɑ
ɲáŋgò	ɲ ɑ ŋ ɡ ow
ɲáŋgó	ɲ ɑ ŋ ɡ ow
ɲáŋgù	ɲ ɑ ŋ ɡ ʉ
ɲáŋɛ̂	ɲ ɑ ŋ ɛ
ɲáɽíŋgɔ́	ɲ ɑ ɹ i ŋ ɡ ɒ
ɲáɽíɲɛ̀	ɲ ɑ ɹ i ɲ ɛ
ɲáɽə̀ŋàt̪ǒ	ɲ ɑ ɹ ə ŋ ɑ t ow
ɲâ	ɲ ɑ
ɲâjɔ́	ɲ ɑ j ɒ
ɲâjɛ̀ðàt̪ɔ́	ɲ ɑ j ɛ ð ɑ t ɒ
ɲâjɛ̀ðò	ɲ ɑ j ɛ ð ow
ɲâjɛ̀ðó	ɲ ɑ j ɛ ð ow
ɲâlaŋavə̀lɛ̀ðá	ɲ ɑ l ɑ ŋ ɑ v ə l ɛ ð ɑ
ɲâvə̀lɛ̀ðà	ɲ ɑ v ə l ɛ ð ɑ
ɲâvə̀lɛ̀ðǎ	ɲ ɑ v ə l ɛ ð ɑ
ɲâvə̀lɛ̀ðɛ̀	ɲ ɑ v ə l ɛ ð ɛ
ɲâvə̀lɛ̀ðɛ̌	ɲ ɑ v ə l ɛ ð ɛ
ɲâvə́lɛ̂ðɛ̀	ɲ ɑ v ə l ɛ ð ɛ
ɲǎjà	ɲ ɑ j ɑ
ɲǎjɛ́ðàðà	ɲ ɑ j ɛ ð ɑ ð ɑ
ɲǎjɛ́ðì	ɲ ɑ j ɛ ð i
ɲéról	ɲ ɛ ɹ ow l
ɲiroba	ɲ i ɹ ow b ɑ
ɲì	ɲ i
ɲìclò	ɲ i tʃ l ow
ɲìcə̀lò	ɲ i tʃ ə l ow
ɲìcə̀ló	ɲ i tʃ ə l ow
ɲìcə̀lù	ɲ i tʃ ə l ʉ
ɲìcə̀lʊ̀	ɲ i tʃ ə l ʊ
ɲìjɔ́l	ɲ i j ɒ l
ɲìjɛ̀ðú	ɲ i j ɛ ð ʉ
ɲìmbɽá	ɲ i m b ɹ ɑ
ɲìtí	ɲ i t i
ɲìt̪ì	ɲ i t i
ɲìt̪útú	ɲ i t ʉ t ʉ
ɲìðɛ̀ní	ɲ i ð ɛ n i
ɲìðɛ̀nɔ́	ɲ i ð ɛ n ɒ
ɲìðɛ̀nɔ̂	ɲ i ð ɛ n ɒ
ɲǐn	ɲ i n
ɲòɽón	ɲ ow ɹ ow n
ɲó	ɲ ow
ɲówà	ɲ ow w ɑ
ɲóɽê	ɲ ow ɹ ɛ
ɲùcò	ɲ ʉ tʃ ow
ɲùmbòɽò	ɲ ʉ m b ow ɹ ow
ɲùmbòɽó	ɲ ʉ m b ow ɹ ow
ɲú	ɲ ʉ
ɲún	ɲ ʉ n
ɲúɽíɲɛ́	ɲ ʉ ɹ i ɲ ɛ
ɲúɽíɲɛ̂	ɲ ʉ ɹ i ɲ ɛ
ɲúɽî	ɲ ʉ ɹ i
ɲɔ̀rɔ̀ðɔ̀	ɲ ɒ ɹ ɒ ð ɒ
ɲɔ̀ɽíŋgɔ́	ɲ ɒ ɹ i ŋ ɡ ɒ
ɲɔ́rɔ̀ðɔ̀	ɲ ɒ ɹ ɒ ð ɒ
ɲɔ́ðɔ́	ɲ ɒ ð ɒ
ɲə̀ɽà	ɲ ə ɹ ɑ
ɲɛ̀	ɲ ɛ
ɲɛ̀clò	ɲ ɛ tʃ l ow
ɲɛ̀làcá	ɲ ɛ l ɑ tʃ ɑ
ɲɛ̀mbə̀ɽó	ɲ ɛ m b ə ɹ ow
ɲɛ̀n	ɲ ɛ n
ɲɛ̀rà	ɲ ɛ ɹ ɑ
ɲɛ̀ɽà	ɲ ɛ ɹ ɑ
ɲɛ́	ɲ ɛ
ɲɛ́dàn	ɲ ɛ d ɑ n
ɲɛ́hɛ̂	ɲ ɛ h ɛ
ɲɛ́lácí	ɲ ɛ l ɑ tʃ i
ɲɛ́n	ɲ ɛ n
ɲɛ́nê	ɲ ɛ n ɛ
ɲɛ́nɛ̀	ɲ ɛ n ɛ
ɲɛ́nɛ́	ɲ ɛ n ɛ
ɲɛ́rá	ɲ ɛ ɹ ɑ
ɲɛ́ɽcân	ɲ ɛ ɹ tʃ ɑ n
ɲɛ̌	ɲ ɛ
ɲɛ̌n	ɲ ɛ n
ɲʊ̀mbòɽò	ɲ ʊ m b ow ɹ ow
ɲʊ̀mbòɽó	ɲ ʊ m b ow ɹ ow
ɲʊ̀mbə́ɽó	ɲ ʊ m b ə ɹ ow
ɲ́ɛ̂	ɲ ɛ
ɽà	ɹ ɑ
ɽàpɾì	ɹ ɑ p ɾ i
ɽá	ɹ ɑ
ɽǎ	ɹ ɑ
ɽit̪í	ɹ i t i
ɽìd̪ɛ́ɾɛ́	ɹ i d ɛ ɾ ɛ
ɽìtì	ɹ i t i
ɽìtí	ɹ i t i
ɽìtɔ̀	ɹ i t ɒ
ɽìt̪ì	ɹ i t i
ɽìt̪í	ɹ i t i
ɽìt̪ɔ̀	ɹ i t ɒ
ɽìɲá	ɹ i ɲ ɑ
ɽíd̪ɛ́ɾɛ̀	ɹ i d ɛ ɾ ɛ
ɽítí	ɹ i t i
ɽíɲɔ́	ɹ i ɲ ɒ
ɽó	ɹ ow
ɽót̪ɔ̀	ɹ ow t ɒ
ɽút̪ú	ɹ ʉ t ʉ
ɽ́ɽò	ɹ ɹ ow
ɾàcá	ɾ ɑ tʃ ɑ
ɾácí	ɾ ɑ tʃ i
ɾì	ɾ i
ɾí	ɾ i
ɾíɲá	ɾ i ɲ ɑ
ɾtaŋú	ɾ t ɑ ŋ ʉ
ɾt̪ɔ́ðɛ́	ɾ t ɒ ð ɛ
ɾɔ̀	ɾ ɒ
ɾɔ̀ðɔ̀	ɾ ɒ ð ɒ
ɾɔ́ðɔ́	ɾ ɒ ð ɒ
ɾə̀mná	ɾ ə m n ɑ
ɾə̀mə̀ná	ɾ ə m ə n ɑ
ɾə̀vɛ́	ɾ ə v ɛ
ɾə́mná	ɾ ə m n ɑ
ɾə́mə́ná	ɾ ə m ə n ɑ
ʃárɔ̀nŋʊ́	ʃ ɑ ɹ ɒ n ŋ ʊ
ʃárɔ̀nʊ́	ʃ ɑ ɹ ɒ n ʊ
ʃárə́n	ʃ ɑ ɹ ə n
ʃáɾə̀nəŋwɔ̀	ʃ ɑ ɾ ə n ə ŋ w ɒ
ʊ̀mì	ʊ m i
ʊ̀mí	ʊ m i
ʊ̀mɔ̀	ʊ m ɒ
ʊ̀mɔ́	ʊ m ɒ
ʊ̀mɔ̂	ʊ m ɒ
ʊ̀nì	ʊ n i
ʊ̀nɛ̀ɾɛ̀	ʊ n ɛ ɾ ɛ
ʊ́m	ʊ m
ʊ́mɔ́	ʊ m ɒ
ʊ́nì	ʊ n i
̀àvə̀ðàcá	ɑ v ə ð ɑ tʃ ɑ
̀ìɾí	i ɾ i
̀là	l ɑ
̀làvŕðɛ̀	l ɑ v ɹ ð ɛ
̀mùt̪ɔ̀	m ʉ t ɒ
̀n	n
̀nɔ́	n ɒ
̀nɛ̀ɾɛ̀	n ɛ ɾ ɛ
̀nɛ́	n ɛ
̀rùn	ɹ ʉ n
̀rɟɔ̀t̪ɔ̀	ɹ dʒ ɒ t ɒ
̀ẁ̀	w
́díɔr	d i ɒ ɹ
́nì	n i
́óɾá	ow ɾ ɑ
́rdðɛ̀cí	ɹ d ð ɛ tʃ i
́ðí	ð i
́ŋnà	ŋ n ɑ
́ŋná	ŋ n ɑ
́ɔ́tú	ɒ t ʉ
́ɲà	ɲ ɑ
́ɲá	ɲ ɑ
́ɽɛ̀	ɹ ɛ
