íŋgá	i ŋ ɡ ɑ
ɾɔ́ðà	ɾ ɒ ð ɑ
lə̀və̀lɛ̀ðɜ́lló	l ə v ə l ɛ ð ɐ l l ow
únɛ́ɾɛ́	ʉ n ɛ ɾ ɛ
láló	l ɑ l ow
və́lɛ̀ðà	v ə l ɛ ð ɑ
nd̪ɔ̀bàgɛ̀	n d ɒ b ɑ ɡ ɛ
lə̀və̀lɛ̀ðɛ́ló	l ə v ə l ɛ ð ɛ l ow
kə̀və̀lɛ̀ðɔ́l	k ə v ə l ɛ ð ɒ l
ùnɛ́ɾɛ́	ʉ n ɛ ɾ ɛ
èɽò	ɛ ɹ ow
jìcə̀lò	j i tʃ ə l ow
lɛ̀ĺ	l ɛ l
və́lɛ̀ðɛ̀	v ə l ɛ ð ɛ
àjú	ɑ j ʉ
d̪úɾɔ̀	d ʉ ɾ ɒ
kə́nɔ̀nà	k ə n ɒ n ɑ
ìmìdánŋwɔ́	i m i d ɑ n ŋ w ɒ
jáŋú	j ɑ ŋ ʉ
láró	l ɑ ɹ ow
ðà	ð ɑ
lɛ́ĺ	l ɛ l
və̀lɛ̀ðɔ́	v ə l ɛ ð ɒ
ábŕó	ɑ b ɹ ow
t̪ɔ́wɜ̀nì	t ɒ w ɐ n i
ìrɔ́	i ɹ ɒ
làŋúl	l ɑ ŋ ʉ l
lə̀və̀lɛ̀ðɜ́l	l ə v ə l ɛ ð ɐ l
mùðù	m ʉ ð ʉ
ŋgá	ŋ ɡ ɑ
íjɛ̀	i j ɛ
úɽì	ʉ ɹ i
ɛ́lɔ́	ɛ l ɒ
àvàn	ɑ v ɑ n
àɾò	ɑ ɾ ow
kìcə̀lò	k i tʃ ə l ow
dòɾè	d ow ɾ ɛ
lìcə̀lò	l i tʃ ə l ow
ŋgál	ŋ ɡ ɑ l
nɔ́nà	n ɒ n ɑ
kɜ́lùŋú	k ɐ l ʉ ŋ ʉ
ŋgɛ́ĺ	ŋ ɡ ɛ l
jə́t̪ə̀vɛ̀	j ə t ə v ɛ
ðár	ð ɑ ɹ
jàŋcí	j ɑ ŋ tʃ i
ápɾíɲá	ɑ p ɾ i ɲ ɑ
ŋɛ́nɛ̀	ŋ ɛ n ɛ
rmàn	ɹ m ɑ n
rɔ̀là	ɹ ɒ l ɑ
kúkù	k ʉ k ʉ
kápìt̪ɔ̀	k ɑ p i t ɒ
kákàŋú	k ɑ k ɑ ŋ ʉ
índɔ̀	i n d ɒ
lʊ̀tú	l ʊ t ʉ
íŋgà	i ŋ ɡ ɑ
ðàŋàlà	ð ɑ ŋ ɑ l ɑ
ɛ́là	ɛ l ɑ
lə̀t̪ə̀vɛ̀	l ə t ə v ɛ
ágàŋɛ̂	ɑ ɡ ɑ ŋ ɛ
və̀lɛ̀ðɛ̀	v ə l ɛ ð ɛ
ɛ̀làɽà	ɛ l ɑ ɹ ɑ
kə̀ðìɲɔ́	k ə ð i ɲ ɒ
bácʊ̂m	b ɑ tʃ ʊ m
ràló	ɹ ɑ l ow
rìcə̀lò	ɹ i tʃ ə l ow
àn	ɑ n
ɔ́ɟɔ́	ɒ dʒ ɒ
kál	k ɑ l
nd̪ɔ̀bà	n d ɒ b ɑ
kícə̀lò	k i tʃ ə l ow
ìlí	i l i
àpɾí	ɑ p ɾ i
jà	j ɑ
ágá	ɑ ɡ ɑ
d̪ùɾɔ́	d ʉ ɾ ɒ
làɾt̪ìðì	l ɑ ɾ t i ð i
ìjɔ̀	i j ɒ
lálèŋɔ́	l ɑ l ɛ ŋ ɒ
ŋgɛ́l	ŋ ɡ ɛ l
ŋə̀t̪ə̀vɛ̀	ŋ ə t ə v ɛ
kùmɔ̀t̪ɔ̀	k ʉ m ɒ t ɒ
nátɛ́	n ɑ t ɛ
já	j ɑ
ðáŋàlà	ð ɑ ŋ ɑ l ɑ
íŋgátɛ́	i ŋ ɡ ɑ t ɛ
ɲàĺl	ɲ ɑ l l
ðə́t̪ə́vá	ð ə t ə v ɑ
là	l ɑ
mɛ́rðàt̪ɛ̀	m ɛ ɹ ð ɑ t ɛ
ŋáɽə̀ŋàt̪à	ŋ ɑ ɹ ə ŋ ɑ t ɑ
ŋávɛ́	ŋ ɑ v ɛ
ɲálá	ɲ ɑ l ɑ
ɔ́ɟɔ́ŋá	ɒ dʒ ɒ ŋ ɑ
lə́r̀lɛ̀ɲíl	l ə ɹ l ɛ ɲ i l
búlì	b ʉ l i
álpúɾɔ́	ɑ l p ʉ ɾ ɒ
òɾà	ow ɾ ɑ
ŋàɽàt̪ɛ̀	ŋ ɑ ɹ ɑ t ɛ
ùɽɟɛ̀n	ʉ ɹ dʒ ɛ n
kɔ́lɔ̀t̪ɔ̀	k ɒ l ɒ t ɒ
kə̀t̪ìjí	k ə t i j i
órá	ow ɹ ɑ
káɽə̀ŋàt̪à	k ɑ ɹ ə ŋ ɑ t ɑ
bɔ́lú	b ɒ l ʉ
ndrɛ̀ð	n d ɹ ɛ ð
nìcə̀lò	n i tʃ ə l ow
ɲál	ɲ ɑ l
áɽə̀ŋàt̪à	ɑ ɹ ə ŋ ɑ t ɑ
àbr̀á	ɑ b ɹ ɑ
ŋán	ŋ ɑ n
ŋìcə̀lò	ŋ i tʃ ə l ow
kàŋcíŋì	k ɑ ŋ tʃ i ŋ i
ɛ́ŋúŋ	ɛ ŋ ʉ ŋ
kúkùŋú	k ʉ k ʉ ŋ ʉ
dɛ̀	d ɛ
ɽíɲìnɔ̀	ɹ i ɲ i n ɒ
làvə̀lɛ̀	l ɑ v ə l ɛ
ðá	ð ɑ
úrnɔ̀	ʉ ɹ n ɒ
lìcò	l i tʃ ow
ŋáŋú	ŋ ɑ ŋ ʉ
jùrú	j ʉ ɹ ʉ
làĺ	l ɑ l
léɲál	l ɛ ɲ ɑ l
ɛ́làɽà	ɛ l ɑ ɹ ɑ
ká	k ɑ
dɔ́ŋðɛ̀	d ɒ ŋ ð ɛ
lə̀vàvɾà	l ə v ɑ v ɾ ɑ
lápà	l ɑ p ɑ
ðə́və̀lɛ̀ðà	ð ə v ə l ɛ ð ɑ
èdɔ̀ɽɔ̀	ɛ d ɒ ɹ ɒ
jít̪ɔ̀	j i t ɒ
lə̀və̀lɛ̀ðáɲál	l ə v ə l ɛ ð ɑ ɲ ɑ l
ágéɲár	ɑ ɡ ɛ ɲ ɑ ɹ
ŋə̀màð	ŋ ə m ɑ ð
làɾân	l ɑ ɾ ɑ n
ŋgɛ̀	ŋ ɡ ɛ
ðə̀lə̀ŋà	ð ə l ə ŋ ɑ
ðìcə̀lò	ð i tʃ ə l ow
lə̀ɾ̀làndɔ́	l ə ɾ l ɑ n d ɒ
áúr	ɑ ʉ ɹ
jál	j ɑ l
lúrnɔ̀	l ʉ ɹ n ɒ
nà	n ɑ
kámàɽàŋá	k ɑ m ɑ ɹ ɑ ŋ ɑ
lə̀və̀lɛ̀ðáló	l ə v ə l ɛ ð ɑ l ow
d̪úɾɛ̀	d ʉ ɾ ɛ
kə̀və̀lɛ̀ðéɲárɛ́	k ə v ə l ɛ ð ɛ ɲ ɑ ɹ ɛ
ádɔ̀ŋðɔ́	ɑ d ɒ ŋ ð ɒ
álɛ́	ɑ l ɛ
sɔ̀ɽíŋgɔ́	s ɒ ɹ i ŋ ɡ ɒ
ŋgàl	ŋ ɡ ɑ l
ɾ́lándɔ́	ɾ l ɑ n d ɒ
àúr	ɑ ʉ ɹ
líɟí	l i dʒ i
úd̪ɛ̀	ʉ d ɛ
nùðɛ̀	n ʉ ð ɛ
làmìɲí	l ɑ m i ɲ i
lɔ́mɛ́	l ɒ m ɛ
ɜ́dì	ɐ d i
kə̀ɽìɲáɲàgɛ́	k ə ɹ i ɲ ɑ ɲ ɑ ɡ ɛ
və̀lɛ̀ðá	v ə l ɛ ð ɑ
âl	ɑ l
vɜ́ɽì	v ɐ ɹ i
àdám	ɑ d ɑ m
ɔ́ɽɟɛ̀cà	ɒ ɹ dʒ ɛ tʃ ɑ
ánó	ɑ n ow
pít̪ɔ́	p i t ɒ
lə́və̀lɛ̀ðɛ̀	l ə v ə l ɛ ð ɛ
íd̪ɛ́rɛ́j	i d ɛ ɹ ɛ j
léɲáĺ	l ɛ ɲ ɑ l
və́lɛ̀ðɔ́	v ə l ɛ ð ɒ
ùrnɔ̀	ʉ ɹ n ɒ
kə̀və̀lɛ̀ðɔ́	k ə v ə l ɛ ð ɒ
lábùðɔ́	l ɑ b ʉ ð ɒ
úðɛ̀	ʉ ð ɛ
lá	l ɑ
dɔ́ɽðàt̪à	d ɒ ɹ ð ɑ t ɑ
ə̀ŋná	ə ŋ n ɑ
t̪ə́vɔ́	t ə v ɒ
ùrú	ʉ ɹ ʉ
áɾt̪ɛ̀	ɑ ɾ t ɛ
və́lɛ́ðɔ́	v ə l ɛ ð ɒ
ɔ̀ðə̀ŋɪ̀nà	ɒ ð ə ŋ ɪ n ɑ
ðə̀vɔ̀ɽɔ̀	ð ə v ɒ ɹ ɒ
ɛ̀ðɛ̀ŋgàló	ɛ ð ɛ ŋ ɡ ɑ l ow
ðàŋàl	ð ɑ ŋ ɑ l
ðə̀və̀lɛ̀ðɔ́	ð ə v ə l ɛ ð ɒ
ðɜ́ɽí	ð ɐ ɹ i
lùnɛ́j	l ʉ n ɛ j
t̪ə́và	t ə v ɑ
jə́t̪ə̀và	j ə t ə v ɑ
t̪ábùðà	t ɑ b ʉ ð ɑ
jə̀və̀lɛ̀ðɔ́lɔ́ŋú	j ə v ə l ɛ ð ɒ l ɒ ŋ ʉ
úrì	ʉ ɹ i
jə̀və̀lɛ̀ðɔ́	j ə v ə l ɛ ð ɒ
ðíɲìðɛ̀t̪ɛ̀	ð i ɲ i ð ɛ t ɛ
kúɽì	k ʉ ɹ i
jɛ̀ðá	j ɛ ð ɑ
ŋə̀t̪ə̀và	ŋ ə t ə v ɑ
álèŋà	ɑ l ɛ ŋ ɑ
nàvlà	n ɑ v l ɑ
nə́ðùɽì	n ə ð ʉ ɹ i
nɛ́	n ɛ
nàjìnɔ̀	n ɑ j i n ɒ
ùlíŋgɛ́	ʉ l i ŋ ɡ ɛ
jə́nɔ̀nɛ̀	j ə n ɒ n ɛ
ðɔ̀mɔ̀cà	ð ɒ m ɒ tʃ ɑ
újɛ̀l	ʉ j ɛ l
ájén	ɑ j ɛ n
ðə̀gʊ̀bʊ̂l	ð ə ɡ ʊ b ʊ l
t̪àɾɔ́t̪ɛ́	t ɑ ɾ ɒ t ɛ
t̪àŋúŋ	t ɑ ŋ ʉ ŋ
ðàlgàrâj	ð ɑ l ɡ ɑ ɹ ɑ j
ðádíjá	ð ɑ d i j ɑ
káɾì	k ɑ ɾ i
ðɛ́t̪áj	ð ɛ t ɑ j
ðɔ̀là	ð ɒ l ɑ
ndɾɛ̀ð	n d ɾ ɛ ð
t̪ɔ́ɾt̪ɔ́l	t ɒ ɾ t ɒ l
lə̀kə̀lcà	l ə k ə l tʃ ɑ
àvɟìgɛ́	ɑ v dʒ i ɡ ɛ
lə̀kə̀lcì	l ə k ə l tʃ i
ùðɛ̀	ʉ ð ɛ
kà	k ɑ
kɛ́cì	k ɛ tʃ i
ŋɔ̀mɔ̀	ŋ ɒ m ɒ
kə̀kɛ̀cɛ̀cí	k ə k ɛ tʃ ɛ tʃ i
ŋɔ́mɔ̀	ŋ ɒ m ɒ
dún	d ʉ n
kájì	k ɑ j i
àpɾíɲá	ɑ p ɾ i ɲ ɑ
káɾìðà	k ɑ ɾ i ð ɑ
ðə́lə̀ŋà	ð ə l ə ŋ ɑ
ðə̀r̀à	ð ə ɹ ɑ
ðámìɲàcíðɛ́	ð ɑ m i ɲ ɑ tʃ i ð ɛ
kɛ̀cɛ̀cí	k ɛ tʃ ɛ tʃ i
lə̀lə̀ŋìt̪ɔ́l	l ə l ə ŋ i t ɒ l
làɾɔ́	l ɑ ɾ ɒ
lɛ́	l ɛ
t̪á	t ɑ
lə̀mɛ̀ɾðɔ́l	l ə m ɛ ɾ ð ɒ l
t̪ùt̪ì	t ʉ t i
ɔ́ndì	ɒ n d i
káɾɔ́gɛ́	k ɑ ɾ ɒ ɡ ɛ
ŋɛ́n	ŋ ɛ n
ŕlɛ̀ɲì	ɹ l ɛ ɲ i
kə̀r̀lɛ̀ɲí	k ə ɹ l ɛ ɲ i
t̪ùdí	t ʉ d i
t̪à	t ɑ
cʊ̀mú	tʃ ʊ m ʉ
t̪ìcə̀lò	t i tʃ ə l ow
ùjɛ̀l	ʉ j ɛ l
èmàð	ɛ m ɑ ð
ònì	ow n i
kámàɽà	k ɑ m ɑ ɹ ɑ
ðɜ̀ríbì	ð ɐ ɹ i b i
ðámìɲíðɛ́	ð ɑ m i ɲ i ð ɛ
ðálèŋɔ́ŋ	ð ɑ l ɛ ŋ ɒ ŋ
kə̀pìt̪ɔ́	k ə p i t ɒ
kápìt̪ɛ̀	k ɑ p i t ɛ
kápìt̪ɔ́	k ɑ p i t ɒ
èmàɽðɛ́n	ɛ m ɑ ɹ ð ɛ n
ɛ́gɛ́n	ɛ ɡ ɛ n
láɽə̀ŋàt̪ɔ́	l ɑ ɹ ə ŋ ɑ t ɒ
t̪áɾɔ́	t ɑ ɾ ɒ
t̪ɛ́	t ɛ
t̪ə̀mɛ̀ɾðɔ́	t ə m ɛ ɾ ð ɒ
t̪ə̀ɽà	t ə ɹ ɑ
kámìɲàcí	k ɑ m i ɲ ɑ tʃ i
kámìɲí	k ɑ m i ɲ i
ðə̀lə̀ŋàt̪ɛ̀	ð ə l ə ŋ ɑ t ɛ
kàɽə̀ŋàt̪ɔ́	k ɑ ɹ ə ŋ ɑ t ɒ
váɾɔ́	v ɑ ɾ ɒ
vàɾá	v ɑ ɾ ɑ
àðə̀ɲɛ́n	ɑ ð ə ɲ ɛ n
gʊ̀bʊ̂l	ɡ ʊ b ʊ l
ŋ́rɔ́mɔ̂	ŋ ɹ ɒ m ɒ
ájènɛ́	ɑ j ɛ n ɛ
ŋɛ́nɛ́	ŋ ɛ n ɛ
ŋáó	ŋ ɑ ow
ŋàɽə̀ŋàt̪ìnɔ̀	ŋ ɑ ɹ ə ŋ ɑ t i n ɒ
ŋíà	ŋ i ɑ
kə̀mànà	k ə m ɑ n ɑ
ŋúdòɾè	ŋ ʉ d ow ɾ ɛ
ŋrɔ̂bà	ŋ ɹ ɒ b ɑ
áɾðɔ́	ɑ ɾ ð ɒ
áɽə́ŋát̪át̪ɔ́	ɑ ɹ ə ŋ ɑ t ɑ t ɒ
làɽə̀ŋàt̪ɔ́	l ɑ ɹ ə ŋ ɑ t ɒ
áɽə́ŋát̪ɔ́	ɑ ɹ ə ŋ ɑ t ɒ
ʊ̀mí	ʊ m i
dìjɔ́	d i j ɒ
áɾlát̪ɔ́	ɑ ɾ l ɑ t ɒ
cúcù	tʃ ʉ tʃ ʉ
lídí	l i d i
lə́ɽà	l ə ɹ ɑ
láj	l ɑ j
ɲáló	ɲ ɑ l ow
tásá	t ɑ s ɑ
ŋɔ̀rà	ŋ ɒ ɹ ɑ
lɛ̀mbré	l ɛ m b ɹ ɛ
láɽə̀ŋàt̪à	l ɑ ɹ ə ŋ ɑ t ɑ
jáɽó	j ɑ ɹ ow
ðúpà	ð ʉ p ɑ
ádám	ɑ d ɑ m
káɾɛ̀	k ɑ ɾ ɛ
jàɾìt̪ɔ́	j ɑ ɾ i t ɒ
ídì	i d i
ðɔ̀ndà	ð ɒ n d ɑ
jàt̪ɔ́	j ɑ t ɒ
álkúrcì	ɑ l k ʉ ɹ tʃ i
ùɽɔ́	ʉ ɹ ɒ
ùn	ʉ n
ɛ̀màð	ɛ m ɑ ð
ɛ̀màðáj	ɛ m ɑ ð ɑ j
kɜ́cí	k ɐ tʃ i
úɽɟɛ̀n	ʉ ɹ dʒ ɛ n
túðà	t ʉ ð ɑ
kə̀mɛ̀ðìt̪ɔ́	k ə m ɛ ð i t ɒ
kə̀mìðìt̪ɔ́	k ə m i ð i t ɒ
ɛ̀bɛ̀	ɛ b ɛ
álá	ɑ l ɑ
kə́lcà	k ə l tʃ ɑ
ŋúɔ́	ŋ ʉ ɒ
ŋɔ́ɾɛ̀	ŋ ɒ ɾ ɛ
lɜ́ndì	l ɐ n d i
láɾɔ́lɛ́	l ɑ ɾ ɒ l ɛ
kájìnɔ́	k ɑ j i n ɒ
lúɔ́	l ʉ ɒ
lə̀t̪ɾì	l ə t ɾ i
íðɔ̀	i ð ɒ
ðɾɔ́	ð ɾ ɒ
jɛ́və̀lɛ̀cɛ̀cí	j ɛ v ə l ɛ tʃ ɛ tʃ i
lɛ̀ŋgɛ́n	l ɛ ŋ ɡ ɛ n
íbɔ́	i b ɒ
t̪òlé	t ow l ɛ
lɔ̀ɽɟɛ̀n	l ɒ ɹ dʒ ɛ n
ŋòɾá	ŋ ow ɾ ɑ
ŕɽò	ɹ ɹ ow
làpɔ́	l ɑ p ɒ
súɽú	s ʉ ɹ ʉ
t̪ɔ́t̪ɔ́	t ɒ t ɒ
jápìjɔ̀	j ɑ p i j ɒ
ɔ́ɾɛ́	ɒ ɾ ɛ
ɽìt̪ì	ɹ i t i
ltɔ́	l t ɒ
ɔ̀pí	ɒ p i
ŋáɽàt̪ɛ̀	ŋ ɑ ɹ ɑ t ɛ
jámìɲíl	j ɑ m i ɲ i l
jɛ́l	j ɛ l
íjà	i j ɑ
òló	ow l ow
jàmìɲí	j ɑ m i ɲ i
ɛ́gàló	ɛ ɡ ɑ l ow
lə́mɔ́ð	l ə m ɒ ð
ðə̀nɔ̀nɔ́	ð ə n ɒ n ɒ
ɲɛ̀	ɲ ɛ
nɛ̀	n ɛ
námál	n ɑ m ɑ l
lìdì	l i d i
lə̀mɔ́ð	l ə m ɒ ð
úɽɟɛ́nɛ́	ʉ ɹ dʒ ɛ n ɛ
t̪ə̀r̀lɛ̀ɲí	t ə ɹ l ɛ ɲ i
námálá	n ɑ m ɑ l ɑ
ðɔ̀mɔ̀cɔ̀	ð ɒ m ɒ tʃ ɒ
ðápàt̪ɛ̀	ð ɑ p ɑ t ɛ
ɛ̀ðɛ̀	ɛ ð ɛ
t̪ìjɔ́	t i j ɒ
ɛ́ðɛ̀	ɛ ð ɛ
àt̪ùɟâj	ɑ t ʉ dʒ ɑ j
áá	ɑ ɑ
ìt̪ɔ́	i t ɒ
dɛ̂	d ɛ
ímìdán	i m i d ɑ n
t̪àwì	t ɑ w i
kàgɛ́	k ɑ ɡ ɛ
ánìjí	ɑ n i j i
àvàlà	ɑ v ɑ l ɑ
kálèŋɛ̀	k ɑ l ɛ ŋ ɛ
kə̀ŋàcí	k ə ŋ ɑ tʃ i
t̪ə́vɛ̀	t ə v ɛ
múðù	m ʉ ð ʉ
kɛ̂	k ɛ
ɲàkàɾó	ɲ ɑ k ɑ ɾ ow
ùɽì	ʉ ɹ i
kɔ̀là	k ɒ l ɑ
rɔ́ɽár	ɹ ɒ ɹ ɑ ɹ
rɛ̂	ɹ ɛ
ɜ̀nì	ɐ n i
óló	ow l ow
kàŋcáŋà	k ɑ ŋ tʃ ɑ ŋ ɑ
kə̀ŋàcáŋá	k ə ŋ ɑ tʃ ɑ ŋ ɑ
lɔ̀mɔ̀	l ɒ m ɒ
ðólá	ð ow l ɑ
kə̀dɔ̀ŋðɔ̀t̪ɔ́	k ə d ɒ ŋ ð ɒ t ɒ
lə́bó	l ə b ow
ŋáɾà	ŋ ɑ ɾ ɑ
t̪ə̀nɔ̀nɔ́	t ə n ɒ n ɒ
kə́dɔ̀ŋðɔ̀t̪ɔ́	k ə d ɒ ŋ ð ɒ t ɒ
jâ	j ɑ
ðáŋâl	ð ɑ ŋ ɑ l
lə̀və́r	l ə v ə ɹ
ɛ̀lɛ̀	ɛ l ɛ
jə̀kàɾàt̪ɔ́	j ə k ɑ ɾ ɑ t ɒ
ðówɛ́	ð ow w ɛ
lə́və́r	l ə v ə ɹ
áɔ̀ɾt̪ɔ́	ɑ ɒ ɾ t ɒ
ŋál	ŋ ɑ l
áɾt̪íjí	ɑ ɾ t i j i
át̪ɔ́	ɑ t ɒ
úlùŋú	ʉ l ʉ ŋ ʉ
ŋə́və̀lɛ̀ðɛ̀	ŋ ə v ə l ɛ ð ɛ
làŋɔ́	l ɑ ŋ ɒ
áré	ɑ ɹ ɛ
kèɲá	k ɛ ɲ ɑ
ŋá	ŋ ɑ
mànú	m ɑ n ʉ
ŋàrɽàt̪ɛ̀	ŋ ɑ ɹ ɹ ɑ t ɛ
gâj	ɡ ɑ j
jɔ̀ɽáɾɛ́	j ɒ ɹ ɑ ɾ ɛ
vr̀ðìnɔ́	v ɹ ð i n ɒ
ðùɽì	ð ʉ ɹ i
ɲɛ̌n	ɲ ɛ n
ɲìcə̀lò	ɲ i tʃ ə l ow
rɔ̀ɽátɛ́	ɹ ɒ ɹ ɑ t ɛ
lárɔ́	l ɑ ɹ ɒ
vŕðìnɔ̀	v ɹ ð i n ɒ
və́lɛ̀ðàt̪à	v ə l ɛ ð ɑ t ɑ
èd̪ɛ̀ɾɛ́	ɛ d ɛ ɾ ɛ
nɛ̀là	n ɛ l ɑ
ná	n ɑ
ðúɽà	ð ʉ ɹ ɑ
ŋìðɛ̀ní	ŋ i ð ɛ n i
ŋə̀ɽà	ŋ ə ɹ ɑ
t̪ólé	t ow l ɛ
ŋə́ɽà	ŋ ə ɹ ɑ
ŋɜ́dɛ̀cì	ŋ ɐ d ɛ tʃ i
t̪òlèɲá	t ow l ɛ ɲ ɑ
kə̀mùt̪ìnɔ́	k ə m ʉ t i n ɒ
ɲà	ɲ ɑ
kə̀mùt̪ɛ́ŋí	k ə m ʉ t ɛ ŋ i
lə́bìɽáló	l ə b i ɹ ɑ l ow
ɔ́ɽà	ɒ ɹ ɑ
kàɾìt̪ɔ́l	k ɑ ɾ i t ɒ l
ŋə́və̀lɛ̀ðà	ŋ ə v ə l ɛ ð ɑ
làɾìt̪ɔ́lɔ́ŋ	l ɑ ɾ i t ɒ l ɒ ŋ
lə̀və̀lɛ̀ðà	l ə v ə l ɛ ð ɑ
kàɾìt̪ɔ́	k ɑ ɾ i t ɒ
látɛ́	l ɑ t ɛ
kàŋáŋà	k ɑ ŋ ɑ ŋ ɑ
kàŋátɛ́	k ɑ ŋ ɑ t ɛ
ɔ́ðà	ɒ ð ɑ
râj	ɹ ɑ j
ápɾí	ɑ p ɾ i
láɾò	l ɑ ɾ ow
vr̀ðɔ́	v ɹ ð ɒ
kə̀mùt̪ɔ̀	k ə m ʉ t ɒ
nɔ́là	n ɒ l ɑ
ɲə̀və̀lɛ̀ðáŋà	ɲ ə v ə l ɛ ð ɑ ŋ ɑ
jə́və̀lɛ̀ðìnɔ́	j ə v ə l ɛ ð i n ɒ
kə̀və̀lɛ̀ðɛ́ŋí	k ə v ə l ɛ ð ɛ ŋ i
jìnɔ́	j i n ɒ
kàðɛ́ŋɛ́n	k ɑ ð ɛ ŋ ɛ n
lə̀mùt̪ɔ̀	l ə m ʉ t ɒ
nɔ́ɾŋú	n ɒ ɾ ŋ ʉ
kə̀mùt̪ìnɔ́ŋ	k ə m ʉ t i n ɒ ŋ
náĺ	n ɑ l
làɾìt̪ɔ́	l ɑ ɾ i t ɒ
ŋátɛ́	ŋ ɑ t ɛ
ɽáɲìðà	ɹ ɑ ɲ i ð ɑ
ídɔ̀	i d ɒ
ùmɔ́	ʉ m ɒ
íjɔ́	i j ɒ
jɛ̂	j ɛ
káĺ	k ɑ l
t̪ólèɲá	t ow l ɛ ɲ ɑ
lùɽùvɔ́	l ʉ ɹ ʉ v ɒ
kə̀və̀lɛ̀ðáɲà	k ə v ə l ɛ ð ɑ ɲ ɑ
ðə̀və̀lɛ̀ðɔ́ŋ	ð ə v ə l ɛ ð ɒ ŋ
ŋɛ́ɲɛ́	ŋ ɛ ɲ ɛ
dɔ̀ɽðàt̪ɔ́	d ɒ ɹ ð ɑ t ɒ
ə́ŋná	ə ŋ n ɑ
ðɔ́rndɛ̀	ð ɒ ɹ n d ɛ
ðə̀cùlɔ̀	ð ə tʃ ʉ l ɒ
lál	l ɑ l
àɽó	ɑ ɹ ow
ɛ́ŋná	ɛ ŋ n ɑ
láŋáló	l ɑ ŋ ɑ l ow
ìt̪ɔ̀t̪ɔ́	i t ɒ t ɒ
díjɔ́	d i j ɒ
ɛ́ɽɛ́	ɛ ɹ ɛ
ávə̀lɛ̀ðɔ́éɲárɛ́	ɑ v ə l ɛ ð ɒ ɛ ɲ ɑ ɹ ɛ
lálèŋà	l ɑ l ɛ ŋ ɑ
káblàt̪à	k ɑ b l ɑ t ɑ
jə́və̀lɛ̀ðáŋà	j ə v ə l ɛ ð ɑ ŋ ɑ
nə́və̀lɛ̀ðɛ́ŋì	n ə v ə l ɛ ð ɛ ŋ i
kə̀və̀lɛ̀ðáŋá	k ə v ə l ɛ ð ɑ ŋ ɑ
ɽòt̪ɔ́	ɹ ow t ɒ
ðə́ɾɔ̀vɛ́	ð ə ɾ ɒ v ɛ
ŋə̀r̀nà	ŋ ə ɹ n ɑ
lúrì	l ʉ ɹ i
ŋgéɲâ	ŋ ɡ ɛ ɲ ɑ
və̀lɛ̀ðà	v ə l ɛ ð ɑ
lə̀və̀lɛ̀ðlɔ́ŋú	l ə v ə l ɛ ð l ɒ ŋ ʉ
t̪àl	t ɑ l
ŋàl	ŋ ɑ l
váɾɛ̀	v ɑ ɾ ɛ
várà	v ɑ ɹ ɑ
jə́və̀lɛ̀ðátɛ́	j ə v ə l ɛ ð ɑ t ɛ
lávə̀lɔ́	l ɑ v ə l ɒ
àŋná	ɑ ŋ n ɑ
íŋgáŋâ	i ŋ ɡ ɑ ŋ ɑ
ŋgɛ́	ŋ ɡ ɛ
dɔ̀ŋðɔ̀t̪ɔ́	d ɒ ŋ ð ɒ t ɒ
ŋìðìjí	ŋ i ð i j i
ŋámìɲì	ŋ ɑ m i ɲ i
ɲàlátɛ́	ɲ ɑ l ɑ t ɛ
kɔ̀ɽɟɛ̀cíŋ	k ɒ ɹ dʒ ɛ tʃ i ŋ
və́lɛ̀ðìnɔ́ŕ	v ə l ɛ ð i n ɒ ɹ
nìjɔ́	n i j ɒ
náŋà	n ɑ ŋ ɑ
ðáŋàl	ð ɑ ŋ ɑ l
kɔ̀ɽɟɛ̀cíŋì	k ɒ ɹ dʒ ɛ tʃ i ŋ i
ŋácà	ŋ ɑ tʃ ɑ
kɔ́ɽɟɛ̀cì	k ɒ ɹ dʒ ɛ tʃ i
ɔ́ɽɟɛ̀cì	ɒ ɹ dʒ ɛ tʃ i
ɔ́ɽɟɛ̀cí	ɒ ɹ dʒ ɛ tʃ i
ðámlá	ð ɑ m l ɑ
ɲáláŋɛ̂	ɲ ɑ l ɑ ŋ ɛ
láŋâ	l ɑ ŋ ɑ
və́lɛ̀ðàt̪ɛ̀ŕ	v ə l ɛ ð ɑ t ɛ ɹ
nə́r̀dɔ́	n ə ɹ d ɒ
ŋə̀bó	ŋ ə b ow
lɛ̀màɽðén	l ɛ m ɑ ɹ ð ɛ n
ðə́kìðɔ̀	ð ə k i ð ɒ
kìjɔ́	k i j ɒ
ŋɔ́mɔ̀ŋnú	ŋ ɒ m ɒ ŋ n ʉ
ðɔ́lá	ð ɒ l ɑ
ŋúgɔ́	ŋ ʉ ɡ ɒ
lùɽbɔ́	l ʉ ɹ b ɒ
nɜ́rú	n ɐ ɹ ʉ
íd̪ɛ́rɛ́n	i d ɛ ɹ ɛ n
íd̪ɛ́rɜ̀lí	i d ɛ ɹ ɐ l i
ɔ̀mnɛ́	ɒ m n ɛ
ðə́kíðɔ́	ð ə k i ð ɒ
ɔ̀r	ɒ ɹ
láŋɛ̂	l ɑ ŋ ɛ
ŋə̀kìðɛ̀	ŋ ə k i ð ɛ
ðə́mút̪ínɔ́	ð ə m ʉ t i n ɒ
lɔ́vɛ́ɽá	l ɒ v ɛ ɹ ɑ
íd̪ɛ́ràló	i d ɛ ɹ ɑ l ow
ŋgéɲá	ŋ ɡ ɛ ɲ ɑ
kɔ̀ɽɟɛ̀cáŋà	k ɒ ɹ dʒ ɛ tʃ ɑ ŋ ɑ
kɔ̀ɽɟɛ̀cíŋí	k ɒ ɹ dʒ ɛ tʃ i ŋ i
t̪ál	t ɑ l
kə́və̀lɛ̀ðɔ́	k ə v ə l ɛ ð ɒ
ájà	ɑ j ɑ
léɲár	l ɛ ɲ ɑ ɹ
t̪ə̀və̀lɛ̀ðɔ́ŋ	t ə v ə l ɛ ð ɒ ŋ
láɾà	l ɑ ɾ ɑ
lə́màð	l ə m ɑ ð
ðə́váɾá	ð ə v ɑ ɾ ɑ
ìjá	i j ɑ
mɛ́ðɔ́	m ɛ ð ɒ
lɔ́ɽà	l ɒ ɹ ɑ
árìt̪ɔ́	ɑ ɹ i t ɒ
ŋɔ́ɽɟɛ̀cà	ŋ ɒ ɹ dʒ ɛ tʃ ɑ
ŋə́wàjì	ŋ ə w ɑ j i
ðámácíðá	ð ɑ m ɑ tʃ i ð ɑ
íd̪ɛ́rɜ̀lír	i d ɛ ɹ ɐ l i ɹ
lajlɜ̀lír	l ɑ j l ɐ l i ɹ
lajlɜ̀lí	l ɑ j l ɐ l i
áǹɔ́ŋ	ɑ n ɒ ŋ
kɛ́	k ɛ
ɔ̀nt̪ɔ̀t̪ɔ́	ɒ n t ɒ t ɒ
ŕlɔ̀ɲɔ̀	ɹ l ɒ ɲ ɒ
láɾɛ́	l ɑ ɾ ɛ
ðə́kɔ̀cɔ̀	ð ə k ɒ tʃ ɒ
d̪úd̪ɔ̀	d ʉ d ɒ
nɛ́lê	n ɛ l ɛ
ŋìbíl	ŋ i b i l
ðádɔ́ŋɔ́níjɔ́	ð ɑ d ɒ ŋ ɒ n i j ɒ
ŋútìðɔ̀	ŋ ʉ t i ð ɒ
ŋə̀r̀lɛ̀ɲì	ŋ ə ɹ l ɛ ɲ i
láɾl̀à	l ɑ ɾ l ɑ
ðə́ɲɛ̀làcà	ð ə ɲ ɛ l ɑ tʃ ɑ
lòðà	l ow ð ɑ
ɛ̀mànáj	ɛ m ɑ n ɑ j
ðə̀ŋgə̀lá	ð ə ŋ ɡ ə l ɑ
ɔ́ðə̀ŋɪ̀nà	ɒ ð ə ŋ ɪ n ɑ
kə́r̀lɛ̀ɲí	k ə ɹ l ɛ ɲ i
ŋɔ̂n	ŋ ɒ n
kə́nɔ̀nìt̪ɔ̀t̪ɔ́l	k ə n ɒ n i t ɒ t ɒ l
jɔ́	j ɒ
ɔ̀ɽɟɛ̀cìnɔ́	ɒ ɹ dʒ ɛ tʃ i n ɒ
át̪ú	ɑ t ʉ
ɲáŋìŋnú	ɲ ɑ ŋ i ŋ n ʉ
lɔ̀ɲɔ̀	l ɒ ɲ ɒ
lɔ̀ɲà	l ɒ ɲ ɑ
ɔ́ɽɟɛ̀cìnɔ̀	ɒ ɹ dʒ ɛ tʃ i n ɒ
ðìdú	ð i d ʉ
kájìnìjɔ̀	k ɑ j i n i j ɒ
kákà	k ɑ k ɑ
ŋə́kɔ̀t̪ìnɔ̀	ŋ ə k ɒ t i n ɒ
t̪ɛ́t̪ɛ̀	t ɛ t ɛ
ld̪ɛ́rlɜ̀lí	l d ɛ ɹ l ɐ l i
lìdɜ́lló	l i d ɐ l l ow
kə̀t̪ú	k ə t ʉ
bùlìjɛ̀cí	b ʉ l i j ɛ tʃ i
ŋáwóŋ	ŋ ɑ w ow ŋ
kə́ŋàcìnɔ́	k ə ŋ ɑ tʃ i n ɒ
kàjìnìjì	k ɑ j i n i j i
r̀lɛ̀ɲí	ɹ l ɛ ɲ i
lɛ́ŋgɛ́n	l ɛ ŋ ɡ ɛ n
lɛ́ŋgɜ́lí	l ɛ ŋ ɡ ɐ l i
kápɔ́	k ɑ p ɒ
ɔ̀ráj	ɒ ɹ ɑ j
t̪àwìðì	t ɑ w i ð i
ɲɔ́ðɔ́	ɲ ɒ ð ɒ
jáŋcí	j ɑ ŋ tʃ i
kàɾɔ́ŋ	k ɑ ɾ ɒ ŋ
ámɛ̀ɾðɔ́	ɑ m ɛ ɾ ð ɒ
áɽó	ɑ ɹ ow
jáɾɔ́jɛ́	j ɑ ɾ ɒ j ɛ
jə̀ðɔ́jɛ́	j ə ð ɒ j ɛ
kàɾó	k ɑ ɾ ow
ŋà	ŋ ɑ
mɛ̀ɾðá	m ɛ ɾ ð ɑ
ágàgɛ́	ɑ ɡ ɑ ɡ ɛ
làŋìðàt̪ɔ́	l ɑ ŋ i ð ɑ t ɒ
ùnɜ̀lír	ʉ n ɐ l i ɹ
níjɔ̀	n i j ɒ
ùlùŋú	ʉ l ʉ ŋ ʉ
ŋùbút̪ú	ŋ ʉ b ʉ t ʉ
kə̀pìðú	k ə p i ð ʉ
jɛ́ɾɔ̀ðìt̪ɔ́	j ɛ ɾ ɒ ð i t ɒ
lɛ́ŋgáj	l ɛ ŋ ɡ ɑ j
ŋúcɔ́	ŋ ʉ tʃ ɒ
kìdáŋágɛ́	k i d ɑ ŋ ɑ ɡ ɛ
gɛ́nɛ̀	ɡ ɛ n ɛ
kàŋíŋì	k ɑ ŋ i ŋ i
káŋíŋí	k ɑ ŋ i ŋ i
pɔ̀	p ɒ
ɾɔ́ðɛ̀	ɾ ɒ ð ɛ
pít̪ɔ̀	p i t ɒ
wáɛ́n	w ɑ ɛ n
újə́lɛ́	ʉ j ə l ɛ
úɽìðàt̪à	ʉ ɹ i ð ɑ t ɑ
ávàn	ɑ v ɑ n
kàŋú	k ɑ ŋ ʉ
ŋə́nɛ̀ðɔ́l	ŋ ə n ɛ ð ɒ l
káŋú	k ɑ ŋ ʉ
ðɔ́ndà	ð ɒ n d ɑ
kə̀t̪ɔ̀t̪ɔ́	k ə t ɒ t ɒ
ŋə́kàɾó	ŋ ə k ɑ ɾ ow
ŋípíjɔ́	ŋ i p i j ɒ
ðɔ̀ndɔ̀	ð ɒ n d ɒ
ðə̀ŋàcìnɔ́	ð ə ŋ ɑ tʃ i n ɒ
lə̀ré	l ə ɹ ɛ
nìjɔ̀	n i j ɒ
ágáŋɛ̂	ɑ ɡ ɑ ŋ ɛ
ŋgátɛ́	ŋ ɡ ɑ t ɛ
ŋgéɲár	ŋ ɡ ɛ ɲ ɑ ɹ
jáló	j ɑ l ow
áò	ɑ ow
ŋùrì	ŋ ʉ ɹ i
íjɔ̀	i j ɒ
lə̀və̀lɛ̀cì	l ə v ə l ɛ tʃ i
lɔ́mɔ̀	l ɒ m ɒ
kúɽcɜ́l	k ʉ ɹ tʃ ɐ l
lùrì	l ʉ ɹ i
ŋúrɔ̀	ŋ ʉ ɹ ɒ
ŋúrì	ŋ ʉ ɹ i
lə̀vàɾà	l ə v ɑ ɾ ɑ
vɜ́ɽɛ́cí	v ɐ ɹ ɛ tʃ i
ɲɛ́n	ɲ ɛ n
ɲájɛ̀ðàt̪ɔ́	ɲ ɑ j ɛ ð ɑ t ɒ
ìmbɽá	i m b ɹ ɑ
várát̪ɔ́	v ɑ ɹ ɑ t ɒ
vɔ̀ɽɔ̀cɔ́	v ɒ ɹ ɒ tʃ ɒ
áŋt̪ɔ́ú	ɑ ŋ t ɒ ʉ
lə̀r̀lɛ̀ɲì	l ə ɹ l ɛ ɲ i
lə̀vɜ̀ɽì	l ə v ɐ ɹ i
lùrnɔ̀	l ʉ ɹ n ɒ
ðɛ́nɛ̀	ð ɛ n ɛ
jèðìŋnú	j ɛ ð i ŋ n ʉ
ńɔ́	n ɒ
ðápà	ð ɑ p ɑ
nə̀və̀lɛ̀ðà	n ə v ə l ɛ ð ɑ
láwó	l ɑ w ow
lə̀və̀lɛ̀ðɔ́lɔ́ŋú	l ə v ə l ɛ ð ɒ l ɒ ŋ ʉ
ɲàjɔ́	ɲ ɑ j ɒ
néɲâ	n ɛ ɲ ɑ
àpá	ɑ p ɑ
ìndɔ̀	i n d ɒ
t̪àɽà	t ɑ ɹ ɑ
jábr̀à	j ɑ b ɹ ɑ
ŋə̀mt̪ɛ́ɾɛ́	ŋ ə m t ɛ ɾ ɛ
ápɔ́	ɑ p ɒ
kéɲár	k ɛ ɲ ɑ ɹ
jɛ́ĺ	j ɛ l
ŋávt̪ɔ́	ŋ ɑ v t ɒ
ðíjà	ð i j ɑ
t̪áŋìjɔ̀	t ɑ ŋ i j ɒ
ŋóðà	ŋ ow ð ɑ
ðə̀gʊ̀bʊ́lɔ̀	ð ə ɡ ʊ b ʊ l ɒ
lèdéɲá	l ɛ d ɛ ɲ ɑ
nál	n ɑ l
mánì	m ɑ n i
lɔ̀dɔ́	l ɒ d ɒ
làló	l ɑ l ow
léŋt̪à	l ɛ ŋ t ɑ
àɟà	ɑ dʒ ɑ
ɛ́léɲɛ́	ɛ l ɛ ɲ ɛ
lálló	l ɑ l l ow
d̪úɾɔ́	d ʉ ɾ ɒ
ní	n i
jápà	j ɑ p ɑ
ɲàláŋâ	ɲ ɑ l ɑ ŋ ɑ
làlló	l ɑ l l ow
jàl	j ɑ l
t̪ɔ́	t ɒ
áɔ̀nt̪ɔ́	ɑ ɒ n t ɒ
gɛ́	ɡ ɛ
lɔ́mɔ́n	l ɒ m ɒ n
lɛ́nɛ̀	l ɛ n ɛ
míɲàt̪ɛ̀	m i ɲ ɑ t ɛ
núr	n ʉ ɹ
lɔ̀ɽìðì	l ɒ ɹ i ð i
bàcʊ̂m	b ɑ tʃ ʊ m
níðú	n i ð ʉ
və́lɛ̀ðàt̪ɔ́	v ə l ɛ ð ɑ t ɒ
lə́vàvɾì	l ə v ɑ v ɾ i
kə́ðìɲɔ́	k ə ð i ɲ ɒ
jɛ̀ĺ	j ɛ l
káɾŋú	k ɑ ɾ ŋ ʉ
ɲàbùðɔ́	ɲ ɑ b ʉ ð ɒ
káɾcí	k ɑ ɾ tʃ i
lə́bú	l ə b ʉ
láŋúl	l ɑ ŋ ʉ l
dòɾèɲà	d ow ɾ ɛ ɲ ɑ
lápɔ́	l ɑ p ɒ
àɽá	ɑ ɹ ɑ
ábùðɔ́	ɑ b ʉ ð ɒ
bácʊ́mɛ́	b ɑ tʃ ʊ m ɛ
lùt̪à	l ʉ t ɑ
nít̪ɔ́	n i t ɒ
t̪ɜ̀díŋ	t ɐ d i ŋ
nɔ̂n	n ɒ n
və́lɛ̀ðɛ̀ŕ	v ə l ɛ ð ɛ ɹ
ðɜ́ríbì	ð ɐ ɹ i b i
ðɔ́ɽiŋ̀t̪úl	ð ɒ ɹ i ŋ t ʉ l
lə̀vàvɾì	l ə v ɑ v ɾ i
dɔ̀ŋðɔ́	d ɒ ŋ ð ɒ
t̪ə́mànàt̪à	t ə m ɑ n ɑ t ɑ
lə̀və̀lɛ̀ðáɲâl	l ə v ə l ɛ ð ɑ ɲ ɑ l
ðə́və̀lɛ̀ðɔ́	ð ə v ə l ɛ ð ɒ
kə̀bùlìjí	k ə b ʉ l i j i
ðɔ́mɔ̀cɔ̀	ð ɒ m ɒ tʃ ɒ
lə́dɔ̀ŋðɔ́	l ə d ɒ ŋ ð ɒ
nùjɛ̀l	n ʉ j ɛ l
nàlðàlgarájɛ́	n ɑ l ð ɑ l ɡ ɑ ɹ ɑ j ɛ
láŋàt̪ìt̪ɔ̀	l ɑ ŋ ɑ t i t ɒ
óɾà	ow ɾ ɑ
nàt̪ùɟáì	n ɑ t ʉ dʒ ɑ i
nàðàlgàrâj	n ɑ ð ɑ l ɡ ɑ ɹ ɑ j
t̪ìjɔ́l	t i j ɒ l
édɔ̀ɽɔ̀	ɛ d ɒ ɹ ɒ
lámìɲí	l ɑ m i ɲ i
ðə́və́lɛ́ðá	ð ə v ə l ɛ ð ɑ
lèdé	l ɛ d ɛ
kə́ǹà	k ə n ɑ
lúmɔ́n	l ʉ m ɒ n
àbùðá	ɑ b ʉ ð ɑ
ɲáŋgɔ̂	ɲ ɑ ŋ ɡ ɒ
ábùðà	ɑ b ʉ ð ɑ
úɽcàcìjɔ̀	ʉ ɹ tʃ ɑ tʃ i j ɒ
ŋɔ̀ɾɛ̀	ŋ ɒ ɾ ɛ
ŋàɾà	ŋ ɑ ɾ ɑ
nàvɟìgɛ́	n ɑ v dʒ i ɡ ɛ
kə̀bùlìjíŋì	k ə b ʉ l i j i ŋ i
ŋùdòɾè	ŋ ʉ d ow ɾ ɛ
ídɔ̀t̪ɔ́	i d ɒ t ɒ
nàŋnò	n ɑ ŋ n ow
láŋìŋnú	l ɑ ŋ i ŋ n ʉ
rɛt̪áj	ɹ ɛ t ɑ j
lɔ́ɽàt̪ɛ̀	l ɒ ɹ ɑ t ɛ
kʊ́mbʊ̀r	k ʊ m b ʊ ɹ
áɾĺɔ́	ɑ ɾ l ɒ
rùŋɔ́	ɹ ʉ ŋ ɒ
ɛ̀mànàló	ɛ m ɑ n ɑ l ow
kàɾá	k ɑ ɾ ɑ
lábùðà	l ɑ b ʉ ð ɑ
láɽó	l ɑ ɹ ow
nàré	n ɑ ɹ ɛ
ðə̀rnà	ð ə ɹ n ɑ
èrnà	ɛ ɹ n ɑ
kíjà	k i j ɑ
ɲàlàŋâ	ɲ ɑ l ɑ ŋ ɑ
rɛt̪ɛ́n	ɹ ɛ t ɛ n
írɔ́	i ɹ ɒ
ðɛ́t̪ɛ́n	ð ɛ t ɛ n
ɛ́ðɛ́n	ɛ ð ɛ n
íŋgàŋâ	i ŋ ɡ ɑ ŋ ɑ
káɾó	k ɑ ɾ ow
ŋɔ́ɽàt̪ɔ́	ŋ ɒ ɹ ɑ t ɒ
líjɔ́	l i j ɒ
ɛ̀màðɛ́n	ɛ m ɑ ð ɛ n
ɾɔ́ðàt̪à	ɾ ɒ ð ɑ t ɑ
lə̀kɔ̀t̪ɔ̀t̪ɔ́	l ə k ɒ t ɒ t ɒ
ìbɔ́	i b ɒ
ŋɔ́ɽàt̪átɛ́	ŋ ɒ ɹ ɑ t ɑ t ɛ
lɔ́ɽɛ̀	l ɒ ɹ ɛ
t̪ə̀mànì	t ə m ɑ n i
làŋâ	l ɑ ŋ ɑ
ɔ́ɽìt̪ɛ̀	ɒ ɹ i t ɛ
kɔ́t̪ɔ̀t̪à	k ɒ t ɒ t ɑ
ɾ́làndá	ɾ l ɑ n d ɑ
ɛ́nɛ́n	ɛ n ɛ n
lə̀r̀dɔ́	l ə ɹ d ɒ
áŋú	ɑ ŋ ʉ
nɔ̀ŋnɔ̀	n ɒ ŋ n ɒ
bùlú	b ʉ l ʉ
lìɟí	l i dʒ i
ŋàɽà	ŋ ɑ ɹ ɑ
ùdí	ʉ d i
ðúɽì	ð ʉ ɹ i
ɔ́dà	ɒ d ɑ
və̀lɛ̀cìðú	v ə l ɛ tʃ i ð ʉ
və́lɛ̀cíŕ	v ə l ɛ tʃ i ɹ
àpìnìjí	ɑ p i n i j i
ðə́kə̀lcà	ð ə k ə l tʃ ɑ
kéɲà	k ɛ ɲ ɑ
ŋɛ̀	ŋ ɛ
ábúðɔ́	ɑ b ʉ ð ɒ
lìnd̪ɔ̀t̪ɔ́	l i n d ɒ t ɒ
índ̪ɛ̀t̪ɛ̀	i n d ɛ t ɛ
ɛ̀là	ɛ l ɑ
lámìɲì	l ɑ m i ɲ i
ádɔ̀ŋɔ̀nɛ̀	ɑ d ɒ ŋ ɒ n ɛ
ŋə̀nɔ̀nìnɔ́	ŋ ə n ɒ n i n ɒ
lìðɔ́	l i ð ɒ
úd̪ɔ̀	ʉ d ɒ
kə̀lə̀ŋìt̪ɔ́	k ə l ə ŋ i t ɒ
ápìjɔ̀	ɑ p i j ɒ
ɔ́ɾɛ̀	ɒ ɾ ɛ
ŕŋɔ̀	ɹ ŋ ɒ
ùd̪ɔ́	ʉ d ɒ
pínìjɔ̀	p i n i j ɒ
lámìɲà	l ɑ m i ɲ ɑ
lánt̪ɛ̀	l ɑ n t ɛ
úrmùðɔ̀	ʉ ɹ m ʉ ð ɒ
jɛ́kàɾìt̪ɔ́	j ɛ k ɑ ɾ i t ɒ
áɽàŋgár	ɑ ɹ ɑ ŋ ɡ ɑ ɹ
míɲɛ̀	m i ɲ ɛ
lə̀bùlìjí	l ə b ʉ l i j i
ðɔ́mɔ̀cà	ð ɒ m ɒ tʃ ɑ
lɜ̀dí	l ɐ d i
ɾ́làndìt̪ɔ̀	ɾ l ɑ n d i t ɒ
ár̀nɔ́ŋú	ɑ ɹ n ɒ ŋ ʉ
lɔ́t̪ɔ́	l ɒ t ɒ
lábr̀t̪ɛ̀	l ɑ b ɹ t ɛ
ŋɔ̀ɽíŋgɔ́	ŋ ɒ ɹ i ŋ ɡ ɒ
jɛ́r̀lɛ̀ɲìnɔ́	j ɛ ɹ l ɛ ɲ i n ɒ
lə̀ŋàcí	l ə ŋ ɑ tʃ i
ŋgáŋâ	ŋ ɡ ɑ ŋ ɑ
ɔ̀ŋcɔ̀	ɒ ŋ tʃ ɒ
ŋgáŋɛ̂	ŋ ɡ ɑ ŋ ɛ
àŋnɔ̀	ɑ ŋ n ɒ
ámácí	ɑ m ɑ tʃ i
ŋgà	ŋ ɡ ɑ
lɔ́dɔ́	l ɒ d ɒ
índ̪ɔ́t̪ɔ́	i n d ɒ t ɒ
lɔ́dà	l ɒ d ɑ
mɛ̀ðɔ́	m ɛ ð ɒ
lə̀kɔ̀t̪ìnɔ́	l ə k ɒ t i n ɒ
ɲàɽíŋgó	ɲ ɑ ɹ i ŋ ɡ ow
ðɔ́	ð ɒ
ðə́kàɾó	ð ə k ɑ ɾ ow
làwólɛ́	l ɑ w ow l ɛ
úrmúðɔ́	ʉ ɹ m ʉ ð ɒ
lìjìnɔ́	l i j i n ɒ
ìðɔ́	i ð ɒ
kíðìnɔ́	k i ð i n ɒ
ŋə́kàɾàt̪ɔ́l	ŋ ə k ɑ ɾ ɑ t ɒ l
áɾá	ɑ ɾ ɑ
rámɔ̀nɛ̀t̪ɛ̀	ɹ ɑ m ɒ n ɛ t ɛ
t̪àbùðɔ́l	t ɑ b ʉ ð ɒ l
lìt̪ə̀ɾɔ́	l i t ə ɾ ɒ
lɔ̀n	l ɒ n
líjà	l i j ɑ
ìjɔ́	i j ɒ
kàŋìt̪ɔ́	k ɑ ŋ i t ɒ
ɜ́dí	ɐ d i
ðàbr̀à	ð ɑ b ɹ ɑ
ŋàŋìt̪ɔ́l	ŋ ɑ ŋ i t ɒ l
ɔ̀ɽìt̪ɔ́	ɒ ɹ i t ɒ
káló	k ɑ l ow
mɛ́ðà	m ɛ ð ɑ
t̪ə̀vɔ́	t ə v ɒ
ávə̀là	ɑ v ə l ɑ
ðə́pɔ́	ð ə p ɒ
ɲálà	ɲ ɑ l ɑ
jə̀mɛ̀ɾðɔ́	j ə m ɛ ɾ ð ɒ
jìtàn	j i t ɑ n
àɽàŋgár	ɑ ɹ ɑ ŋ ɡ ɑ ɹ
t̪íjáló	t i j ɑ l ow
kátɛ́	k ɑ t ɛ
áŋìnɛ̀	ɑ ŋ i n ɛ
ágà	ɑ ɡ ɑ
nìcɔ́lɔ̀	n i tʃ ɒ l ɒ
kɔ́t̪ìnɔ̀	k ɒ t i n ɒ
jɛ̀	j ɛ
ɲàɽà	ɲ ɑ ɹ ɑ
lə́t̪ə̀vɛ̀	l ə t ə v ɛ
jájɛ̀	j ɑ j ɛ
bíɽɔ́	b i ɹ ɒ
vr̀ðìðú	v ɹ ð i ð ʉ
ðɔ́ðɔ́	ð ɒ ð ɒ
və́lɛ̀ðá	v ə l ɛ ð ɑ
ŕnà	ɹ n ɑ
ðíjɛ́	ð i j ɛ
rə̀m̀à	ɹ ə m ɑ
várì	v ɑ ɹ i
úðɔ́	ʉ ð ɒ
álà	ɑ l ɑ
ŕɔ́ŕ	ɹ ɒ ɹ
ɲàlà	ɲ ɑ l ɑ
ávt̪ɔ́	ɑ v t ɒ
ðə̀ɾɔ̀vɛ́	ð ə ɾ ɒ v ɛ
ásá	ɑ s ɑ
t̪ə́və̀lɛ̀ðɛ́ŋì	t ə v ə l ɛ ð ɛ ŋ i
ŋə́r̀nà	ŋ ə ɹ n ɑ
mánà	m ɑ n ɑ
ðíd̪í	ð i d i
lə́t̪ə̀vɔ́ŕ	l ə t ə v ɒ ɹ
lə́t̪átɛ́ŕ	l ə t ɑ t ɛ ɹ
lə̀t̪átɛ́ŕ	l ə t ɑ t ɛ ɹ
ŋə́t̪ə̀và	ŋ ə t ə v ɑ
jə̀t̪ə̀và	j ə t ə v ɑ
t̪ìðìt̪ɔ́	t i ð i t ɒ
kéðìnìt̪ɔ́	k ɛ ð i n i t ɒ
ávə̀làŕ	ɑ v ə l ɑ ɹ
ŋìjìnɔ̀	ŋ i j i n ɒ
jə́t̪ə̀vìnɔ́	j ə t ə v i n ɒ
t̪ə́vìnɔ̀	t ə v i n ɒ
càt̪á	tʃ ɑ t ɑ
t̪àɾɔ́ŋt̪ɛ́	t ɑ ɾ ɒ ŋ t ɛ
kàɾɔ́	k ɑ ɾ ɒ
kíðìnìt̪ɔ́	k i ð i n i t ɒ
jàɾà	j ɑ ɾ ɑ
nùn	n ʉ n
kə́və̀lɛ̀ðɔ́gɛ́	k ə v ə l ɛ ð ɒ ɡ ɛ
ɲálátɛ́l	ɲ ɑ l ɑ t ɛ l
ðə́t̪ə̀và	ð ə t ə v ɑ
jə̀r̀nà	j ə ɹ n ɑ
jɛ́	j ɛ
jɛ́r̀ɔ́	j ɛ ɹ ɒ
nɜ̀nì	n ɐ n i
lə́mbrá	l ə m b ɹ ɑ
lɛ́mbré	l ɛ m b ɹ ɛ
nɜ́nì	n ɐ n i
ùɟí	ʉ dʒ i
jə̀kɔ̀t̪ìnɔ́	j ə k ɒ t i n ɒ
íjàŕ	i j ɑ ɹ
álátɛ́l	ɑ l ɑ t ɛ l
làvə̀là	l ɑ v ə l ɑ
ɲàlátɛ́l	ɲ ɑ l ɑ t ɛ l
ŋìcɔ́lɔ̀	ŋ i tʃ ɒ l ɒ
ŋòɽón	ŋ ow ɹ ow n
ɲòɽón	ɲ ow ɹ ow n
t̪ə̀vá	t ə v ɑ
nácám	n ɑ tʃ ɑ m
ácámá	ɑ tʃ ɑ m ɑ
ðé	ð ɛ
ré	ɹ ɛ
nɛ̀bɛ̀	n ɛ b ɛ
làjà	l ɑ j ɑ
ðùɽú	ð ʉ ɹ ʉ
ŋíðɛ̀	ŋ i ð ɛ
ŋâl	ŋ ɑ l
ðɛ̀	ð ɛ
kàðə́və́lêðà	k ɑ ð ə v ə l ɛ ð ɑ
rô	ɹ ow
kńnà	k n n ɑ
àɾɔ́	ɑ ɾ ɒ
áɾò	ɑ ɾ ow
ðô	ð ow
jɛ̀rdó	j ɛ ɹ d ow
ráwáɲà	ɹ ɑ w ɑ ɲ ɑ
ðàmàcà	ð ɑ m ɑ tʃ ɑ
ràmàcà	ɹ ɑ m ɑ tʃ ɑ
ðə̀kàɾó	ð ə k ɑ ɾ ow
kápátɛ́	k ɑ p ɑ t ɛ
èðɔ̀ŋɔ̀	ɛ ð ɒ ŋ ɒ
kə́r̀à	k ə ɹ ɑ
ìðɔ̀t̪ɔ́	i ð ɒ t ɒ
nàɽàŋgár	n ɑ ɹ ɑ ŋ ɡ ɑ ɹ
nídáló	n i d ɑ l ow
t̪ə́vìnɛ̀	t ə v i n ɛ
írdɔ́	i ɹ d ɒ
ɲá	ɲ ɑ
ŋìðìnìt̪ɔ́	ŋ i ð i n i t ɒ
ŋìjɔ́l	ŋ i j ɒ l
dɔ́ŋðà	d ɒ ŋ ð ɑ
dɔ́ŋðàt̪ɛ̀	d ɒ ŋ ð ɑ t ɛ
lʊ́tú	l ʊ t ʉ
dɔ́ŋðɔ́	d ɒ ŋ ð ɒ
lùrìjɔ̀	l ʉ ɹ i j ɒ
kə́və̀lɛ̀ðà	k ə v ə l ɛ ð ɑ
káŋìt̪ɔ́	k ɑ ŋ i t ɒ
kúrŋú	k ʉ ɹ ŋ ʉ
pɛ́t̪ɛ̀ŕ	p ɛ t ɛ ɹ
kə̀dɔ̀ŋðɔ́	k ə d ɒ ŋ ð ɒ
ápà	ɑ p ɑ
áɔ̀mɔ̀nɔ́	ɑ ɒ m ɒ n ɒ
óɾɛ́	ow ɾ ɛ
vɾáðà	v ɾ ɑ ð ɑ
d̪ùd̪ɔ̀	d ʉ d ɒ
ðùd̪ɔ̀	ð ʉ d ɒ
vɾàðɔ́	v ɾ ɑ ð ɒ
ðʊ́vɛ́	ð ʊ v ɛ
rʊ́vɛ́	ɹ ʊ v ɛ
lə̀mɛ̀ðɔ́	l ə m ɛ ð ɒ
t̪ɔ̀	t ɒ
ðít̪ɔ̀	ð i t ɒ
ɽót̪à	ɹ ow t ɑ
rɔ̀mɔ̀cà	ɹ ɒ m ɒ tʃ ɑ
nɔ́nɛ̀	n ɒ n ɛ
àvə̀lá	ɑ v ə l ɑ
návlà	n ɑ v l ɑ
ðúɽú	ð ʉ ɹ ʉ
lìjɔ́	l i j ɒ
ríjì	ɹ i j i
nə̀mɛ̀ðɔ́l	n ə m ɛ ð ɒ l
lâɾò	l ɑ ɾ ow
lɛ̀	l ɛ
nɔ̀mnɛ́	n ɒ m n ɛ
nìcò	n i tʃ ow
ŋə̀ðɔ́l	ŋ ə ð ɒ l
nə̀mìðì	n ə m i ð i
jínɔ̀ŕ	j i n ɒ ɹ
nàɽìðú	n ɑ ɹ i ð ʉ
ŋə́máðɛ́	ŋ ə m ɑ ð ɛ
áǹɔ́ŋú	ɑ n ɒ ŋ ʉ
jɛ́ùrmùðɔ́	j ɛ ʉ ɹ m ʉ ð ɒ
jàŋú	j ɑ ŋ ʉ
t̪àŋú	t ɑ ŋ ʉ
ŋùrìjɔ̀	ŋ ʉ ɹ i j ɒ
vɾáðɔ́	v ɾ ɑ ð ɒ
kàɾɔ́gɛ́	k ɑ ɾ ɒ ɡ ɛ
kàŋúŋ	k ɑ ŋ ʉ ŋ
káŋúŋ	k ɑ ŋ ʉ ŋ
ðéɲáðɛ́	ð ɛ ɲ ɑ ð ɛ
ɔ́ɽàt̪ɛ̀	ɒ ɹ ɑ t ɛ
kə́lɔ̀ɽàt̪ɛ̀	k ə l ɒ ɹ ɑ t ɛ
ðɔ̀ɽɔ́ðɛ́	ð ɒ ɹ ɒ ð ɛ
kɛ́ĺ	k ɛ l
ùrɔ́	ʉ ɹ ɒ
ðə̀jɛ̀ðɔ́	ð ə j ɛ ð ɒ
jɛ́ðɔ́	j ɛ ð ɒ
ìbɜ̀lír	i b ɐ l i ɹ
làjì	l ɑ j i
lə̀jàjà	l ə j ɑ j ɑ
lɔ̀ɽɔ́lɛ́	l ɒ ɹ ɒ l ɛ
ed̪ɔɽɔlɛdel	ɛ d ɒ ɹ ɒ l ɛ d ɛ l
èdə̀ɽɔ̀l	ɛ d ə ɹ ɒ l
jájìnɔ̀	j ɑ j i n ɒ
ŋɔ̀ɽɔ̀t̪ɛ̀	ŋ ɒ ɹ ɒ t ɛ
kàmɔ̀nɛ̀	k ɑ m ɒ n ɛ
jɔ́mɔ̀nɔ́l	j ɒ m ɒ n ɒ l
kámɔ̀nìt̪ɔ́	k ɑ m ɒ n i t ɒ
kɔ́mɔ̀nɔ́	k ɒ m ɒ n ɒ
jɔ̀mɔ̀nɔ́l	j ɒ m ɒ n ɒ l
búlìjɔ̀	b ʉ l i j ɒ
áfàn	ɑ f ɑ n
ɲʊ̀mbòɽó	ɲ ʊ m b ow ɹ ow
ɲə̀r̀à	ɲ ə ɹ ɑ
ŋʊ̀mbòɽó	ŋ ʊ m b ow ɹ ow
ŋàɾân	ŋ ɑ ɾ ɑ n
kùmɔ̀ŋt̪ú	k ʉ m ɒ ŋ t ʉ
ðìjìðú	ð i j i ð ʉ
ŋáɾân	ŋ ɑ ɾ ɑ n
nɛ̂	n ɛ
ðə̀màn	ð ə m ɑ n
úrɔ̀	ʉ ɹ ɒ
ɲáɽíŋgó	ɲ ɑ ɹ i ŋ ɡ ow
ɲɛ́	ɲ ɛ
vɾàðá	v ɾ ɑ ð ɑ
ðúd̪ɔ̀	ð ʉ d ɒ
lə̀vɾàðɔ́	l ə v ɾ ɑ ð ɒ
ðúd̪ɔ́	ð ʉ d ɒ
jɛ́ðà	j ɛ ð ɑ
jɛ̀ðɔ́	j ɛ ð ɒ
t̪ɔ̀ɽɔ́l	t ɒ ɹ ɒ l
làdìjà	l ɑ d i j ɑ
ðút̪ú	ð ʉ t ʉ
jàdìjà	j ɑ d i j ɑ
t̪ə̀ǹŋúl	t ə n ŋ ʉ l
jɛ̀ŕ	j ɛ ɹ
jàɾɔ́	j ɑ ɾ ɒ
ŋàɲà	ŋ ɑ ɲ ɑ
ðə̀t̪ə̀và	ð ə t ə v ɑ
jɔ̀là	j ɒ l ɑ
nít̪ə̀lɔ́	n i t ə l ɒ
ɔ́ɾìnìjɔ̀	ɒ ɾ i n i j ɒ
nìt̪ə̀lɔ́	n i t ə l ɒ
ríjɛ́	ɹ i j ɛ
jùɽcà	j ʉ ɹ tʃ ɑ
lɔ́ɾɔ́	l ɒ ɾ ɒ
t̪ɔ̀ŕ	t ɒ ɹ
kə́t̪ɔ̀ɽɔ́l	k ə t ɒ ɹ ɒ l
ŋɔ̀ɲa	ŋ ɒ ɲ ɑ
ŋə́mànú	ŋ ə m ɑ n ʉ
lít̪rɛ́	l i t ɹ ɛ
lájà	l ɑ j ɑ
jɛ́ðùɽó	j ɛ ð ʉ ɹ ow
rə́ɽà	ɹ ə ɹ ɑ
ðɔ̀ðɔ́	ð ɒ ð ɒ
ŋùɽùvɔ́	ŋ ʉ ɹ ʉ v ɒ
làŋìt̪ɔ́l	l ɑ ŋ i t ɒ l
rɛ́	ɹ ɛ
ðɛ́	ð ɛ
pɔ́	p ɒ
ðábŕá	ð ɑ b ɹ ɑ
ŋə́mt̪ɛ́ɾɛ́	ŋ ə m t ɛ ɾ ɛ
lə̀ðìðó	l ə ð i ð ow
búlíjí	b ʉ l i j i
bùlìjɔ́	b ʉ l i j ɒ
ɔ́dɔ̀	ɒ d ɒ
ɜ̀dí	ɐ d i
lə́kàɾàt̪ɔ́l	l ə k ɑ ɾ ɑ t ɒ l
ɔ́dɔ̀ŋɔ̀nɔ́	ɒ d ɒ ŋ ɒ n ɒ
ɔ́dɔ́ŋɔ́nɔ́	ɒ d ɒ ŋ ɒ n ɒ
lɜ̀dìŋnú	l ɐ d i ŋ n ʉ
lə́dɔ̀ŋðà	l ə d ɒ ŋ ð ɑ
bùlìjí	b ʉ l i j i
lə̀d̪ùɾɔ́	l ə d ʉ ɾ ɒ
lâl	l ɑ l
d̪úɾɔ́t̪ɔ́	d ʉ ɾ ɒ t ɒ
ɛ́lɔ̌	ɛ l ɒ
lə́d̪ùɾɔ́	l ə d ʉ ɾ ɒ
lɔ́dɔ̀ŋɔ̀nɔ̀	l ɒ d ɒ ŋ ɒ n ɒ
áŋná	ɑ ŋ n ɑ
láŋíðó	l ɑ ŋ i ð ow
lə̀d̪ùɾɔ̀t̪ɔ́	l ə d ʉ ɾ ɒ t ɒ
lə̀ðìjìnɔ̀	l ə ð i j i n ɒ
ŋàɽátɛ́	ŋ ɑ ɹ ɑ t ɛ
ðíjìnɔ̀	ð i j i n ɒ
lɔ̂n	l ɒ n
nàɽátɛ́	n ɑ ɹ ɑ t ɛ
lìjɔ́l	l i j ɒ l
lâj	l ɑ j
ìlɔ̀ðɔ́	i l ɒ ð ɒ
ílɛ̀ðɛ̀	i l ɛ ð ɛ
lə́jìnɔ̀	l ə j i n ɒ
lílɔ̀ðɔ̀	l i l ɒ ð ɒ
ílɔ̀ðɔ̀	i l ɒ ð ɒ
jàbùðɔ́l	j ɑ b ʉ ð ɒ l
ðàbùðɔ́l	ð ɑ b ʉ ð ɒ l
lə́d̪ùɾɔ̀t̪ɔ́	l ə d ʉ ɾ ɒ t ɒ
lìlɔ̀ðɔ́	l i l ɒ ð ɒ
ŋgàlógɛ́	ŋ ɡ ɑ l ow ɡ ɛ
kùrɔ̀	k ʉ ɹ ɒ
lə́kàɾólɛ́	l ə k ɑ ɾ ow l ɛ
kíðìnɔ̀	k i ð i n ɒ
kéðìnɔ̀	k ɛ ð i n ɒ
ìnd̪ɔ̀t̪ɔ́	i n d ɒ t ɒ
lə̀kɔ̀t̪ɔ́	l ə k ɒ t ɒ
ónì	ow n i
kɔ́t̪ɛ̀	k ɒ t ɛ
nònì	n ow n i
lɔ́dɛ̀	l ɒ d ɛ
kɔ́t̪à	k ɒ t ɑ
kɔ̀t̪ɔ́	k ɒ t ɒ
ùrmùðɔ́	ʉ ɹ m ʉ ð ɒ
lə́ùrmùðɔ́	l ə ʉ ɹ m ʉ ð ɒ
úrmùðɛ̀	ʉ ɹ m ʉ ð ɛ
índ̪ɔ̀t̪ɔ̀	i n d ɒ t ɒ
línd̪ɔ̀t̪ɔ́	l i n d ɒ t ɒ
lə́vàrúlɛ́	l ə v ɑ ɹ ʉ l ɛ
ðə̀kàɾóðɛ́	ð ə k ɑ ɾ ow ð ɛ
níjà	n i j ɑ
nájìnɔ̀	n ɑ j i n ɒ
lájìnɔ̀	l ɑ j i n ɒ
áɾɛ̀	ɑ ɾ ɛ
lájìnɔ́	l ɑ j i n ɒ
ìjìnɔ́	i j i n ɒ
jínít̪ɔ́	j i n i t ɒ
jɛ́kàɾó	j ɛ k ɑ ɾ ow
lòlá	l ow l ɑ
ɾ́làndìjɔ̀	ɾ l ɑ n d i j ɒ
r̀lɛ̀ɲìjí	ɹ l ɛ ɲ i j i
ŕlɛ́ɲíjí	ɹ l ɛ ɲ i j i
àɾlìnìjɔ́	ɑ ɾ l i n i j ɒ
kə̀ɾ̀làndàt̪ɔ́	k ə ɾ l ɑ n d ɑ t ɒ
lóló	l ow l ow
lə́kàɾàt̪ìŋjú	l ə k ɑ ɾ ɑ t i ŋ j ʉ
lə́kàɾàt̪ɛ́ŋí	l ə k ɑ ɾ ɑ t ɛ ŋ i
lə́kàɾíŋí	l ə k ɑ ɾ i ŋ i
jíbɛ̀cí	j i b ɛ tʃ i
jɛ́kàɾàt̪ɔ́	j ɛ k ɑ ɾ ɑ t ɒ
jə́mìɲàt̪ɔ́	j ə m i ɲ ɑ t ɒ
kɔ́t̪ìnɛ̀	k ɒ t i n ɛ
kɔ́t̪ínɔ́	k ɒ t i n ɒ
kɔ́t̪ɔ́	k ɒ t ɒ
kɔ̀t̪ìnɔ́	k ɒ t i n ɒ
ìjɛ́n	i j ɛ n
ðɔ́ndɔ̀	ð ɒ n d ɒ
ðə́ðìɲíŋì	ð ə ð i ɲ i ŋ i
ðə́kàɾàt̪ɛ́ŋí	ð ə k ɑ ɾ ɑ t ɛ ŋ i
lìt̪rɛ́	l i t ɹ ɛ
nàvə̀là	n ɑ v ə l ɑ
jínɔ́	j i n ɒ
pɛ̀	p ɛ
ðə́mìɲàt̪ɛ́ŋí	ð ə m i ɲ ɑ t ɛ ŋ i
úrmùðɔ́	ʉ ɹ m ʉ ð ɒ
íðɔ́	i ð ɒ
káɾàt̪ɔ́	k ɑ ɾ ɑ t ɒ
ŋ̀gěɲàgɛ̀rɛ́	ŋ ɡ ɛ ɲ ɑ ɡ ɛ ɹ ɛ
ŋám	ŋ ɑ m
vŕðɔ̀	v ɹ ð ɒ
ŋúɽùvɔ́	ŋ ʉ ɹ ʉ v ɒ
ðáléŋá	ð ɑ l ɛ ŋ ɑ
ŋɛ́ŋɛ́	ŋ ɛ ŋ ɛ
ŋə́làɽà	ŋ ə l ɑ ɹ ɑ
t̪ɔ́ŕ	t ɒ ɹ
ŋɛ́ɲ	ŋ ɛ ɲ
ŋə̀ðùɽó	ŋ ə ð ʉ ɹ ow
ŋə̀r̀ɔ́	ŋ ə ɹ ɒ
lòló	l ow l ow
lə̀kàɾì	l ə k ɑ ɾ i
lə̀kàɾcí	l ə k ɑ ɾ tʃ i
kìlɛ̀ðɛ̀	k i l ɛ ð ɛ
kéɲâĺ	k ɛ ɲ ɑ l
ŕɛ̀	ɹ ɛ
nə̀nìt̪ɔ́	n ə n i t ɒ
ńà	n ɑ
t̪áwíŋí	t ɑ w i ŋ i
ŋɔ́t̪ɔ́	ŋ ɒ t ɒ
ŋgéɲágɛ́	ŋ ɡ ɛ ɲ ɑ ɡ ɛ
rɛ̀rɛ́	ɹ ɛ ɹ ɛ
kàɾɛ̀	k ɑ ɾ ɛ
kéɲágɛ́	k ɛ ɲ ɑ ɡ ɛ
ɛ́rɛ́	ɛ ɹ ɛ
ŋáŋíŋí	ŋ ɑ ŋ i ŋ i
ɛ́rdóŕ	ɛ ɹ d ow ɹ
kéɲâĺgɛ́	k ɛ ɲ ɑ l ɡ ɛ
kìbátɛ́ŕ	k i b ɑ t ɛ ɹ
ɲə̀ɽà	ɲ ə ɹ ɑ
ábŕt̪ɔ́	ɑ b ɹ t ɒ
àbr̀t̪á	ɑ b ɹ t ɑ
làbr̀t̪ɔ́	l ɑ b ɹ t ɒ
ŋɔ́ɽíŋgɔ́	ŋ ɒ ɹ i ŋ ɡ ɒ
lə̀t̪ɔ́	l ə t ɒ
lə́t̪ɛ̀	l ə t ɛ
lə̀ǹdó	l ə n d ow
ńdà	n d ɑ
lábr̀ì	l ɑ b ɹ i
ùɽùwɔ̀	ʉ ɹ ʉ w ɒ
lábr̀à	l ɑ b ɹ ɑ
lábr̀ó	l ɑ b ɹ ow
ŋácí	ŋ ɑ tʃ i
lìdáɲà	l i d ɑ ɲ ɑ
ŋàcá	ŋ ɑ tʃ ɑ
ŋàcí	ŋ ɑ tʃ i
ŋácì	ŋ ɑ tʃ i
lɛ́ŋcì	l ɛ ŋ tʃ i
lábr̀t̪à	l ɑ b ɹ t ɑ
lábr̀t̪ɔ́	l ɑ b ɹ t ɒ
lɛ̀ŋcí	l ɛ ŋ tʃ i
áŋcí	ɑ ŋ tʃ i
lə́àŋcí	l ə ɑ ŋ tʃ i
t̪ə̀ðìɲíŋì	t ə ð i ɲ i ŋ i
àlú	ɑ l ʉ
náŋìjɛ̀cí	n ɑ ŋ i j ɛ tʃ i
lólá	l ow l ɑ
jɛ́wàjìnɔ́	j ɛ w ɑ j i n ɒ
áŋìðɔ̀ŋìnɔ̀	ɑ ŋ i ð ɒ ŋ i n ɒ
ðə̀m̀áɲà	ð ə m ɑ ɲ ɑ
jɛ́kwɔ̀t̪ɔ́	j ɛ k w ɒ t ɒ
jɛ́lə̀vcí	j ɛ l ə v tʃ i
rɛ̀	ɹ ɛ
jɛ́lə̀vcàcí	j ɛ l ə v tʃ ɑ tʃ i
lɔ́ɽɔ́	l ɒ ɹ ɒ
t̪ə́mànì	t ə m ɑ n i
jə́lə̀vcí	j ə l ə v tʃ i
rɔ̂n	ɹ ɒ n
kə̀lə̀vcàcíŋí	k ə l ə v tʃ ɑ tʃ i ŋ i
kə̀lə̀vcìðíŋí	k ə l ə v tʃ i ð i ŋ i
jɛ́lə̀vcìt̪ɔ́	j ɛ l ə v tʃ i t ɒ
míɲát̪ɔ́	m i ɲ ɑ t ɒ
míɲɔ́	m i ɲ ɒ
lə̀mìɲɔ́	l ə m i ɲ ɒ
mìɲɔ́	m i ɲ ɒ
t̪â	t ɑ
íðìjɔ̀cɔ̀	i ð i j ɒ tʃ ɒ
lɔ̀ɽɔ́	l ɒ ɹ ɒ
ǹdó	n d ow
làpìjíŋì	l ɑ p i j i ŋ i
lápɛ̀	l ɑ p ɛ
ŋìjɛ̀	ŋ i j ɛ
ìdɔ́	i d ɒ
lə́àvt̪ɔ́	l ə ɑ v t ɒ
kɜ̀dìŋnú	k ɐ d i ŋ n ʉ
órɛ́	ow ɹ ɛ
ánt̪ɛ̀	ɑ n t ɛ
lɔ̀nt̪ɔ́	l ɒ n t ɒ
ŋə́rt̪á	ŋ ə ɹ t ɑ
lɔ̀ɽá	l ɒ ɹ ɑ
kádɔ̀ŋɔ̀nɛ̀	k ɑ d ɒ ŋ ɒ n ɛ
ðə́màn	ð ə m ɑ n
tùtɔ́	t ʉ t ɒ
lə̀tùtɔ́	l ə t ʉ t ɒ
ŋáɽátɛ́	ŋ ɑ ɹ ɑ t ɛ
tútɛ̀	t ʉ t ɛ
tútɔ̀	t ʉ t ɒ
àpìt̪ɔ́	ɑ p i t ɒ
rɔ́mɔ̀cà	ɹ ɒ m ɒ tʃ ɑ
ðùmáɲà	ð ʉ m ɑ ɲ ɑ
lávə̀lɛ́ló	l ɑ v ə l ɛ l ow
və̀lɛ̀cí	v ə l ɛ tʃ i
və́lɛ̀cì	v ə l ɛ tʃ i
lə̀və̀lɛ̀cí	l ə v ə l ɛ tʃ i
ŋə̀ɽàɲìðì	ŋ ə ɹ ɑ ɲ i ð i
lə̀ǹɔ́	l ə n ɒ
áɾɔ́	ɑ ɾ ɒ
ìrí	i ɹ i
ɛ́gɛ̀ɲí	ɛ ɡ ɛ ɲ i
kɔ̀rǹɔ́	k ɒ ɹ n ɒ
úɽcí	ʉ ɹ tʃ i
ŋíðìnɔ́ŋú	ŋ i ð i n ɒ ŋ ʉ
ŋíðìnɔ́	ŋ i ð i n ɒ
nə́ǹɔ́	n ə n ɒ
àɾðìnɔ́	ɑ ɾ ð i n ɒ
lə́t̪à	l ə t ɑ
tá	t ɑ
jɛ́və̀lɛ̀cí	j ɛ v ə l ɛ tʃ i
jɛ́və̀lɛ̀cìt̪ɔ́	j ɛ v ə l ɛ tʃ i t ɒ
kɜ̀dí	k ɐ d i
lə́ɽàɲìðú	l ə ɹ ɑ ɲ i ð ʉ
lə̀ɽàɲìðú	l ə ɹ ɑ ɲ i ð ʉ
àɾðàt̪ɔ́	ɑ ɾ ð ɑ t ɒ
vɜ̀ɽí	v ɐ ɹ i
lə́vɜ̀ɽí	l ə v ɐ ɹ i
jə́ŋàcìt̪ɔ́	j ə ŋ ɑ tʃ i t ɒ
kə̀ɾ̀làndɔ́	k ə ɾ l ɑ n d ɒ
làwìðì	l ɑ w i ð i
ùɽìðó	ʉ ɹ i ð ow
lárɽìðà	l ɑ ɹ ɹ i ð ɑ
ɔ́ɽɟɛ́cí	ɒ ɹ dʒ ɛ tʃ i
ɔ̀ɽɟɛ̀cá	ɒ ɹ dʒ ɛ tʃ ɑ
lə̀vɜ̀ɽí	l ə v ɐ ɹ i
ɔ̀ɽɔ́	ɒ ɹ ɒ
ílí	i l i
úɽíðó	ʉ ɹ i ð ow
ùɽìðá	ʉ ɹ i ð ɑ
lùɽìðó	l ʉ ɹ i ð ow
ùɽcá	ʉ ɹ tʃ ɑ
láɾɔ́	l ɑ ɾ ɒ
úɽcá	ʉ ɹ tʃ ɑ
və́lɛ́cí	v ə l ɛ tʃ i
lə́lɔ̀ɽɔ́	l ə l ɒ ɹ ɒ
làl	l ɑ l
ɔ́ɽɛ̀	ɒ ɹ ɛ
làbùðɔ́	l ɑ b ʉ ð ɒ
àbùðɔ́	ɑ b ʉ ð ɒ
ŋáɾt̪ɛ̀	ŋ ɑ ɾ t ɛ
ŋìðìnɔ́	ŋ i ð i n ɒ
jə́ŋàcí	j ə ŋ ɑ tʃ i
àŋcí	ɑ ŋ tʃ i
ŋɛ́	ŋ ɛ
ámíɲí	ɑ m i ɲ i
àmìɲá	ɑ m i ɲ ɑ
ìɾí	i ɾ i
jíðìnɔ̀	j i ð i n ɒ
gɛ́nà	ɡ ɛ n ɑ
ìt̪ìlɔ́	i t i l ɒ
kár	k ɑ ɹ
bíɽìnɔ̀	b i ɹ i n ɒ
ràpà	ɹ ɑ p ɑ
ŋɛ̂	ŋ ɛ
ŋáŋìjɔ̀	ŋ ɑ ŋ i j ɒ
ìðɔ̀	i ð ɒ
ɾ́làndà	ɾ l ɑ n d ɑ
ɾ̀làndɔ́	ɾ l ɑ n d ɒ
lácà	l ɑ tʃ ɑ
ŋɔ́cɛ́	ŋ ɒ tʃ ɛ
ŋɔ́dɔ̀ŋɔ̀nɔ̀	ŋ ɒ d ɒ ŋ ɒ n ɒ
lɔ́ɽɟɛ̀cà	l ɒ ɹ dʒ ɛ tʃ ɑ
lɔ́ɽɟɛ̀cí	l ɒ ɹ dʒ ɛ tʃ i
ɛ́ɽðó	ɛ ɹ ð ow
ɛ́vàɾt̪à	ɛ v ɑ ɾ t ɑ
ɛ̀ɽðá	ɛ ɹ ð ɑ
ɛ́ɽðì	ɛ ɹ ð i
ɛ̀vàɾt̪à	ɛ v ɑ ɾ t ɑ
lɛ̀ɽðó	l ɛ ɹ ð ow
ŋə̀nɔ̀nìnɔ̀	ŋ ə n ɒ n i n ɒ
lɛ̀vàɾt̪ɔ̀	l ɛ v ɑ ɾ t ɒ
ját̪ɔ́	j ɑ t ɒ
íját̪ɔ́	i j ɑ t ɒ
ìjàt̪á	i j ɑ t ɑ
lə̀jàt̪ɔ́	l ə j ɑ t ɒ
làjàt̪ɛ̀	l ɑ j ɑ t ɛ
lɔ̀ɽɟɛ̀cí	l ɒ ɹ dʒ ɛ tʃ i
lɔ́ɽɟɛ̀cì	l ɒ ɹ dʒ ɛ tʃ i
kìbáló	k i b ɑ l ow
ɛ́ɾá	ɛ ɾ ɑ
nínɛ̀t̪ɛ̀	n i n ɛ t ɛ
nárŋ̀íŋí	n ɑ ɹ ŋ i ŋ i
jàjàt̪à	j ɑ j ɑ t ɑ
íjàt̪à	i j ɑ t ɑ
màt̪à	m ɑ t ɑ
ɛ́ɽðà	ɛ ɹ ð ɑ
ɛ̀ɽðó	ɛ ɹ ð ow
ðàjìðì	ð ɑ j i ð i
vɾáðɛ̀	v ɾ ɑ ð ɛ
íðɛ̀	i ð ɛ
mɛ́ðɛ̀	m ɛ ð ɛ
lájàt̪à	l ɑ j ɑ t ɑ
lájàt̪ɔ́	l ɑ j ɑ t ɒ
lə̀nìt̪ɔ́	l ə n i t ɒ
ár̀nɔ́	ɑ ɹ n ɒ
àúɾɛ́	ɑ ʉ ɾ ɛ
jə̀ɾ̀làndìnɔ̀	j ə ɾ l ɑ n d i n ɒ
íɾí	i ɾ i
údɔ̀	ʉ d ɒ
ád̪ùɾɔ́	ɑ d ʉ ɾ ɒ
úɾì	ʉ ɾ i
jɛ́ɾ̀làndìnɔ́	j ɛ ɾ l ɑ n d i n ɒ
kìðɔ́	k i ð ɒ
ɾ́làndɛ̀	ɾ l ɑ n d ɛ
kə̀r̀lɛ̀ɲìjí	k ə ɹ l ɛ ɲ i j i
ŕlɛ́ɲít̪ɔ́	ɹ l ɛ ɲ i t ɒ
kə̀r̀lɛ̀ɲìt̪ɔ́	k ə ɹ l ɛ ɲ i t ɒ
ɾ̀làndìt̪ɔ́	ɾ l ɑ n d i t ɒ
r̀ŋɔ̀	ɹ ŋ ɒ
jə́nɔ̀nìnɔ́	j ə n ɒ n i n ɒ
làjìnɛ̀	l ɑ j i n ɛ
ládɔ̀ŋɔ̀nɛ̀	l ɑ d ɒ ŋ ɒ n ɛ
kàŋcí	k ɑ ŋ tʃ i
kàŋcíŋí	k ɑ ŋ tʃ i ŋ i
nɔ́nɔ́	n ɒ n ɒ
t̪ì	t i
làŋú	l ɑ ŋ ʉ
ɔ̀ðɔ́	ɒ ð ɒ
láŋú	l ɑ ŋ ʉ
àŋá	ɑ ŋ ɑ
lə̀bùlú	l ə b ʉ l ʉ
jɛ́nɔ̀nìnɔ́	j ɛ n ɒ n i n ɒ
ŋə̀mìɲàt̪ɔ́	ŋ ə m i ɲ ɑ t ɒ
lə̀bɔ̀lú	l ə b ɒ l ʉ
nd̪ɔ́bà	n d ɒ b ɑ
búlà	b ʉ l ɑ
áŋì	ɑ ŋ i
láŋà	l ɑ ŋ ɑ
búlìjì	b ʉ l i j i
ŋéðìnɔ́	ŋ ɛ ð i n ɒ
ɽíɲɛ̀	ɹ i ɲ ɛ
ɽíɲà	ɹ i ɲ ɑ
ŋáɽà	ŋ ɑ ɹ ɑ
ɽìɲɔ́	ɹ i ɲ ɒ
lùdí	l ʉ d i
údì	ʉ d i
lə̀ɽìɲɔ́	l ə ɹ i ɲ ɒ
ðúdɔ̀	ð ʉ d ɒ
ðùdɔ̀	ð ʉ d ɒ
lə́ìlɔ̀ðɔ́	l ə i l ɒ ð ɒ
ɔ̀ɾìnɔ́	ɒ ɾ i n ɒ
ŋɜ́dìnɔ̀	ŋ ɐ d i n ɒ
kə́kə̀lcà	k ə k ə l tʃ ɑ
àlbɾíðɔ́	ɑ l b ɾ i ð ɒ
álbɾíðɔ́	ɑ l b ɾ i ð ɒ
ɔ̀ɾɔ́	ɒ ɾ ɒ
kìjà	k i j ɑ
pìjìnɔ́	p i j i n ɒ
ŋɔ̀là	ŋ ɒ l ɑ
làɽà	l ɑ ɹ ɑ
lɔ̀là	l ɒ l ɑ
lúd̪ɔ́	l ʉ d ɒ
lùd̪ɔ́	l ʉ d ɒ
káɾɔ́	k ɑ ɾ ɒ
jájà	j ɑ j ɑ
ɽíɲɔ́	ɹ i ɲ ɒ
ɽìɲá	ɹ i ɲ ɑ
lə́ɽìɲɔ́	l ə ɹ i ɲ ɒ
pìnɔ́	p i n ɒ
pínɔ̀	p i n ɒ
lə̀kàɾó	l ə k ɑ ɾ ow
ŕɽì	ɹ ɹ i
r̀ɽì	ɹ ɹ i
káɾà	k ɑ ɾ ɑ
t̪ɔ́t̪ɔ̀	t ɒ t ɒ
kə̀ŋàcíŋì	k ə ŋ ɑ tʃ i ŋ i
kə̀ŋàcà	k ə ŋ ɑ tʃ ɑ
kə̀ŋàcáŋà	k ə ŋ ɑ tʃ ɑ ŋ ɑ
jə̀ŋàcí	j ə ŋ ɑ tʃ i
rə̀ŋàcí	ɹ ə ŋ ɑ tʃ i
rə̀mìnɛ̀t̪ɛ̀	ɹ ə m i n ɛ t ɛ
lùrìðɛ̀t̪ɛ̀	l ʉ ɹ i ð ɛ t ɛ
t̪ú	t ʉ
ŋɔ́rnɛ̀t̪ɛ̀	ŋ ɒ ɹ n ɛ t ɛ
kə́lcí	k ə l tʃ i
kə̀lcá	k ə l tʃ ɑ
kə̀kə̀lcí	k ə k ə l tʃ i
àpìjí	ɑ p i j i
pìnìjí	p i n i j i
kɛ̀ɽðó	k ɛ ɹ ð ow
ámúðɛ́	ɑ m ʉ ð ɛ
ɛ̀rdá	ɛ ɹ d ɑ
lɛ̀rdó	l ɛ ɹ d ow
lɛ́rdì	l ɛ ɹ d i
r̀dɔ́	ɹ d ɒ
kíjɔ́l	k i j ɒ l
jápìnìjí	j ɑ p i n i j i
líjɔ́l	l i j ɒ l
ŋíjɔ́l	ŋ i j ɒ l
kɛ̀ɽðìðó	k ɛ ɹ ð i ð ow
lòró	l ow ɹ ow
ŋòró	ŋ ow ɹ ow
lɔ́rɔ́	l ɒ ɹ ɒ
ámànú	ɑ m ɑ n ʉ
ðɔ́là	ð ɒ l ɑ
lə̀mànú	l ə m ɑ n ʉ
ŋɔ́ɽɛ́ŋì	ŋ ɒ ɹ ɛ ŋ i
ŋɔ́ɽɛ̀	ŋ ɒ ɹ ɛ
ɲɔ́ɽɛ̀	ɲ ɒ ɹ ɛ
áɾðát̪ínɔ́	ɑ ɾ ð ɑ t i n ɒ
áɾðát̪ɔ́	ɑ ɾ ð ɑ t ɒ
údɔ́	ʉ d ɒ
ŕlɛ́ɲí	ɹ l ɛ ɲ i
áɾðɛ̀	ɑ ɾ ð ɛ
láɾðà	l ɑ ɾ ð ɑ
láɾðɔ́	l ɑ ɾ ð ɒ
ám̀ɔ́ŋú	ɑ m ɒ ŋ ʉ
lə́r̀lɛ̀ɲí	l ə ɹ l ɛ ɲ i
lə̀r̀lɛ̀ɲí	l ə ɹ l ɛ ɲ i
láɽá	l ɑ ɹ ɑ
ŕlɛ̀ɲí	ɹ l ɛ ɲ i
làbùðà	l ɑ b ʉ ð ɑ
ŕlɔ̀ɲɔ́	ɹ l ɒ ɲ ɒ
kə̀lcí	k ə l tʃ i
ðə́kə́lcá	ð ə k ə l tʃ ɑ
lə̀pɔ́	l ə p ɒ
ŕdà	ɹ d ɑ
ɔ́dá	ɒ d ɑ
lédéɲá	l ɛ d ɛ ɲ ɑ
kə́lcá	k ə l tʃ ɑ
kùrmùðɔ́	k ʉ ɹ m ʉ ð ɒ
nálèŋɔ́	n ɑ l ɛ ŋ ɒ
ðúrmùðɔ́ðɛ́	ð ʉ ɹ m ʉ ð ɒ ð ɛ
júrmùðɔ́jɛ́	j ʉ ɹ m ʉ ð ɒ j ɛ
nálèŋɔ́ŋ	n ɑ l ɛ ŋ ɒ ŋ
làɾðɔ́	l ɑ ɾ ð ɒ
láɾðɛ̀	l ɑ ɾ ð ɛ
ŋáró	ŋ ɑ ɹ ow
lə̀ðɔ́	l ə ð ɒ
ɽìt̪ɔ̀	ɹ i t ɒ
ŋábùðɛ̀	ŋ ɑ b ʉ ð ɛ
ŋámàcà	ŋ ɑ m ɑ tʃ ɑ
ɽít̪ì	ɹ i t i
t̪át̪ɛ́	t ɑ t ɛ
lìdìjí	l i d i j i
kɔ̀t̪á	k ɒ t ɑ
lɔ́mɔ̀nɔ́	l ɒ m ɒ n ɒ
ŋɔ̀ɲɔ̀	ŋ ɒ ɲ ɒ
nàúr	n ɑ ʉ ɹ
lɔ̀mɔ̀nɔ́	l ɒ m ɒ n ɒ
lámɔ̀nɛ̀	l ɑ m ɒ n ɛ
lâ	l ɑ
nɔ́ŋnɔ̀	n ɒ ŋ n ɒ
kíðɔ́	k i ð ɒ
lə̀kìðɔ́	l ə k i ð ɒ
ŋɔ́ɲà	ŋ ɒ ɲ ɑ
kíðɛ̀	k i ð ɛ
ŋɔ̀ɲà	ŋ ɒ ɲ ɑ
kíðɔ̀	k i ð ɒ
lùrú	l ʉ ɹ ʉ
làɾò	l ɑ ɾ ow
nâ	n ɑ
ŋáŋâl	ŋ ɑ ŋ ɑ l
láŋcáló	l ɑ ŋ tʃ ɑ l ow
làŋì	l ɑ ŋ i
lɔ̀ɽàt̪ɛ́ŋì	l ɒ ɹ ɑ t ɛ ŋ i
nàɽó	n ɑ ɹ ow
lɔ̀ɽàt̪ɛ́ŋí	l ɒ ɹ ɑ t ɛ ŋ i
làŋá	l ɑ ŋ ɑ
ŋɔ́ɽà	ŋ ɒ ɹ ɑ
ŋìà	ŋ i ɑ
ɲátɛ́	ɲ ɑ t ɛ
ɔ̀bə̀ðɔ́	ɒ b ə ð ɒ
kə̀r̀dɔ́	k ə ɹ d ɒ
lɛ́ŋcà	l ɛ ŋ tʃ ɑ
ɔ̀bə̀ðá	ɒ b ə ð ɑ
kə̀lɛ̀ŋcáɲà	k ə l ɛ ŋ tʃ ɑ ɲ ɑ
ŋə̀rt̪á	ŋ ə ɹ t ɑ
jə́r̀dɔ́	j ə ɹ d ɒ
lɛ́ŋcí	l ɛ ŋ tʃ i
ŋɔ́ɾt̪ɔ́	ŋ ɒ ɾ t ɒ
lɛ̀ŋcá	l ɛ ŋ tʃ ɑ
ŋɔ̀ɾt̪ɔ́	ŋ ɒ ɾ t ɒ
ŋɔ́ɾt̪ɔ̀	ŋ ɒ ɾ t ɒ
ŋɔ́ɽàt̪à	ŋ ɒ ɹ ɑ t ɑ
vŕðɛ̀	v ɹ ð ɛ
lə̀vr̀ðɔ́	l ə v ɹ ð ɒ
ŋɛ̀ŋɔ̀nɔ́nùjɛ́lɛ̀	ŋ ɛ ŋ ɒ n ɒ n ʉ j ɛ l ɛ
nə̀nɔ̀nɔ́l	n ə n ɒ n ɒ l
jáŋì	j ɑ ŋ i
ðɔ̂n	ð ɒ n
lə́vcí	l ə v tʃ i
lə̀vcá	l ə v tʃ ɑ
lə̀vcí	l ə v tʃ i
lə́vcì	l ə v tʃ i
lə́vcà	l ə v tʃ ɑ
ŋàŋɔ́	ŋ ɑ ŋ ɒ
jámlá	j ɑ m l ɑ
lə̀rùŋú	l ə ɹ ʉ ŋ ʉ
rúŋì	ɹ ʉ ŋ i
lə̀rùŋɔ̀t̪ɔ́	l ə ɹ ʉ ŋ ɒ t ɒ
rúŋɛ̀t̪ɛ̀	ɹ ʉ ŋ ɛ t ɛ
rúŋɔ̀	ɹ ʉ ŋ ɒ
rúŋɔ̀t̪ɔ̀	ɹ ʉ ŋ ɒ t ɒ
rùŋɔ̀t̪ɔ́	ɹ ʉ ŋ ɒ t ɒ
rùŋú	ɹ ʉ ŋ ʉ
kɔ́t̪ìðà	k ɒ t i ð ɑ
ŋɔ́ɽìt̪ɔ̀	ŋ ɒ ɹ i t ɒ
íðínɔ́	i ð i n ɒ
kɔ́t̪ìt̪ìðɔ̀	k ɒ t i t i ð ɒ
kɔ́t̪ìðàt̪à	k ɒ t i ð ɑ t ɑ
ɾɔ́ðìt̪ɔ̀	ɾ ɒ ð i t ɒ
ɛ̀mànɛ́n	ɛ m ɑ n ɛ n
káŋíŋígɛ́	k ɑ ŋ i ŋ i ɡ ɛ
kǎr	k ɑ ɹ
kájà	k ɑ j ɑ
rát̪ɛ̀	ɹ ɑ t ɛ
lɔ̀ɽàt̪áŋà	l ɒ ɹ ɑ t ɑ ŋ ɑ
lɔ́ɽìt̪ɛ̀	l ɒ ɹ i t ɛ
ɔ́ɾìðúŕ	ɒ ɾ i ð ʉ ɹ
kágɛ́	k ɑ ɡ ɛ
ráŋíŋírɛ́	ɹ ɑ ŋ i ŋ i ɹ ɛ
ŋɔ́ɽìt̪ɔ́	ŋ ɒ ɹ i t ɒ
ŋə̀nɔ̀nɔ́l	ŋ ə n ɒ n ɒ l
ɔ̀ɽá	ɒ ɹ ɑ
ɲìt̪ɔ́ŋú	ɲ i t ɒ ŋ ʉ
kálèŋɔ́	k ɑ l ɛ ŋ ɒ
lɛ́ŋgáló	l ɛ ŋ ɡ ɑ l ow
ðíɲí	ð i ɲ i
ŋéðìnɔ̀	ŋ ɛ ð i n ɒ
ðíɲì	ð i ɲ i
ŋèðìnɔ́	ŋ ɛ ð i n ɒ
ɛ́ðǎj	ɛ ð ɑ j
àbùðàt̪ɔ́	ɑ b ʉ ð ɑ t ɒ
ðɛ́t̪ɜ́lí	ð ɛ t ɐ l i
ðɛ́t̪ɜ́líŕ	ð ɛ t ɐ l i ɹ
ðɛ́t̪áló	ð ɛ t ɑ l ow
ɛ́ðɔ̌	ɛ ð ɒ
ɛ́ðàló	ɛ ð ɑ l ow
ɜ́ðú	ɐ ð ʉ
kɔ́t̪ìt̪ɔ̀	k ɒ t i t ɒ
kɔ́t̪ìjìt̪ɔ̀	k ɒ t i j i t ɒ
lòɾà	l ow ɾ ɑ
làjú	l ɑ j ʉ
lájì	l ɑ j i
ŋɔ́rá	ŋ ɒ ɹ ɑ
ùðɔ́	ʉ ð ɒ
jùpì	j ʉ p i
kɛ́ɾá	k ɛ ɾ ɑ
ìɾìcɔ̀cɔ̀	i ɾ i tʃ ɒ tʃ ɒ
t̪ɔ̀ɽá	t ɒ ɹ ɑ
ðìɲú	ð i ɲ ʉ
ðícò	ð i tʃ ow
lɔ̀ɽàt̪ɔ́	l ɒ ɹ ɑ t ɒ
lɔ̀ɽɔ̀t̪ɔ́	l ɒ ɹ ɒ t ɒ
lɔ́rá	l ɒ ɹ ɑ
láɽə̀ŋàt̪ɛ̀	l ɑ ɹ ə ŋ ɑ t ɛ
úɽíðíðí	ʉ ɹ i ð i ð i
ðə̀ðɛ̀ɽì	ð ə ð ɛ ɹ i
ùɽìðìðɔ́	ʉ ɹ i ð i ð ɒ
lɛ̀ɽðìðì	l ɛ ɹ ð i ð i
úɽìðìðì	ʉ ɹ i ð i ð i
ŋídí	ŋ i d i
ŋúɽcà	ŋ ʉ ɹ tʃ ɑ
ŋâj	ŋ ɑ j
lə̀ɽà	l ə ɹ ɑ
mút̪ìnɔ̀	m ʉ t i n ɒ
lə̀tùðú	l ə t ʉ ð ʉ
ŋúðɛ́r	ŋ ʉ ð ɛ ɹ
túðì	t ʉ ð i
ŋùðɛ́r	ŋ ʉ ð ɛ ɹ
úɽìðìðɔ̀	ʉ ɹ i ð i ð ɒ
ùɽìðìðí	ʉ ɹ i ð i ð i
lə̀t̪ə̀vɔ́	l ə t ə v ɒ
lə̀bó	l ə b ow
làɽó	l ɑ ɹ ow
láɽì	l ɑ ɹ i
láɽà	l ɑ ɹ ɑ
túðú	t ʉ ð ʉ
tùðá	t ʉ ð ɑ
lájú	l ɑ j ʉ
lácí	l ɑ tʃ i
làcá	l ɑ tʃ ɑ
ʊ̀mɔ́	ʊ m ɒ
lə́làcí	l ə l ɑ tʃ i
ʊ́mɔ́	ʊ m ɒ
tùðú	t ʉ ð ʉ
àɽàt̪á	ɑ ɹ ɑ t ɑ
úɽcàcìðì	ʉ ɹ tʃ ɑ tʃ i ð i
ùɽcàcìt̪ɔ́	ʉ ɹ tʃ ɑ tʃ i t ɒ
úɽìðìðìjìt̪ɔ̀	ʉ ɹ i ð i ð i j i t ɒ
úɽcácí	ʉ ɹ tʃ ɑ tʃ i
ɔ́ɽɟɛ̀cìðìt̪ɔ̀	ɒ ɹ dʒ ɛ tʃ i ð i t ɒ
làcí	l ɑ tʃ i
ádɔ́ŋɔ́níjí	ɑ d ɒ ŋ ɒ n i j i
àdɔ̀ŋɔ̀nìjɔ́	ɑ d ɒ ŋ ɒ n i j ɒ
làdɔ̀ŋɔ̀nìjí	l ɑ d ɒ ŋ ɒ n i j i
ɲàɔ̀ŋɔ̀ŋɔ̀nìjí	ɲ ɑ ɒ ŋ ɒ ŋ ɒ n i j i
ládɔ̀ŋɔ̀nìjì	l ɑ d ɒ ŋ ɒ n i j i
úɽcàcìðà	ʉ ɹ tʃ ɑ tʃ i ð ɑ
láŋìŋnìjú	l ɑ ŋ i ŋ n i j ʉ
ládɔ̀ŋɔ̀nìjí	l ɑ d ɒ ŋ ɒ n i j i
mút̪ínɔ́	m ʉ t i n ɒ
mùt̪ìnɔ́	m ʉ t i n ɒ
mút̪ìnɛ̀	m ʉ t i n ɛ
lə̀mùt̪ìnɔ́	l ə m ʉ t i n ɒ
lácì	l ɑ tʃ i
lɔ́vɛ́ɽɛ́	l ɒ v ɛ ɹ ɛ
ŋɔ́vɛ́ɽɛ́	ŋ ɒ v ɛ ɹ ɛ
lə̀pìnɔ́	l ə p i n ɒ
kúɾí	k ʉ ɾ i
làpìnɛ̀	l ɑ p i n ɛ
lápìnɔ̀	l ɑ p i n ɒ
lápìnɔ́	l ɑ p i n ɒ
kúrì	k ʉ ɹ i
ɔ́ŋɔ̀ŋɔ̀nìjì	ɒ ŋ ɒ ŋ ɒ n i j i
ðíjá	ð i j ɑ
kàrɽ̀ó	k ɑ ɹ ɹ ow
ɛ́gɔ̌	ɛ ɡ ɒ
ŋə́ɽìɲà	ŋ ə ɹ i ɲ ɑ
ŋɛ̀l	ŋ ɛ l
ápɛ̀	ɑ p ɛ
áŋìnɔ̀	ɑ ŋ i n ɒ
ŋìtàn	ŋ i t ɑ n
áŋìnɔ́	ɑ ŋ i n ɒ
ŋɛ́l	ŋ ɛ l
lə̀ɽìɲàt̪ɔ́	l ə ɹ i ɲ ɑ t ɒ
ŋɛ́rɛ́gɛ̀	ŋ ɛ ɹ ɛ ɡ ɛ
kíjàt̪à	k i j ɑ t ɑ
úɽcàcà	ʉ ɹ tʃ ɑ tʃ ɑ
ùɽcàcí	ʉ ɹ tʃ ɑ tʃ i
ùɽcàcá	ʉ ɹ tʃ ɑ tʃ ɑ
ɔ̀ɽɟɛ̀cìðìt̪ɔ́	ɒ ɹ dʒ ɛ tʃ i ð i t ɒ
lə̀mìɲàt̪ɔ́l	l ə m i ɲ ɑ t ɒ l
lídì	l i d i
ŋúɽcàcìt̪ɔ̀	ŋ ʉ ɹ tʃ ɑ tʃ i t ɒ
ŋɔ́ɽɟɛ̀cí	ŋ ɒ ɹ dʒ ɛ tʃ i
ŋɔ́ɾáló	ŋ ɒ ɾ ɑ l ow
ɔ̀ɽɟɛ̀cìjí	ɒ ɹ dʒ ɛ tʃ i j i
ŋóɾá	ŋ ow ɾ ɑ
ɔ́ɽɟɛ̀cìjɔ̀	ɒ ɹ dʒ ɛ tʃ i j ɒ
ùɽcàcìjí	ʉ ɹ tʃ ɑ tʃ i j i
làlèŋɔ́	l ɑ l ɛ ŋ ɒ
jàlèŋɔ́	j ɑ l ɛ ŋ ɒ
ɛ́ðɛ̀ɲí	ɛ ð ɛ ɲ i
ɛ́rɛ̀ɲí	ɛ ɹ ɛ ɲ i
rə́t̪áló	ɹ ə t ɑ l ow
ɛ́rɛ́n	ɛ ɹ ɛ n
və̀lɛ̀ðàt̪ɔ́	v ə l ɛ ð ɑ t ɒ
káðə́və̀rlɛ̀ð̌ǎ	k ɑ ð ə v ə ɹ l ɛ ð ɑ
rɛt̪ɜ̀lí	ɹ ɛ t ɐ l i
rɛt̪ɜ̀lír	ɹ ɛ t ɐ l i ɹ
kùrmùðɔ̀	k ʉ ɹ m ʉ ð ɒ
kɔ́ɽàt̪ɔ́	k ɒ ɹ ɑ t ɒ
ùɽcàcìjɔ́	ʉ ɹ tʃ ɑ tʃ i j ɒ
ɲáɾà	ɲ ɑ ɾ ɑ
rà	ɹ ɑ
rá	ɹ ɑ
kə́və̀lɛ̀ðàt̪ɔ́	k ə v ə l ɛ ð ɑ t ɒ
ŋìdɔ̀t̪ɔ́	ŋ i d ɒ t ɒ
ídɔ̀t̪ɔ̀	i d ɒ t ɒ
únɛ́	ʉ n ɛ
nɔ̀ná	n ɒ n ɑ
lə̀nɔ̀nɔ́	l ə n ɒ n ɒ
lábòt̪ɛ̀	l ɑ b ow t ɛ
làbòt̪ɔ́	l ɑ b ow t ɒ
lábòt̪à	l ɑ b ow t ɑ
lábòt̪ɔ́	l ɑ b ow t ɒ
jə̀jɔ́l	j ə j ɒ l
jə́ŋkìðú	j ə ŋ k i ð ʉ
lìdɔ̀t̪ɔ́	l i d ɒ t ɒ
ɔ́ŋcɔ̀	ɒ ŋ tʃ ɒ
lɜ́dìŋnú	l ɐ d i ŋ n ʉ
áléŋɔ́	ɑ l ɛ ŋ ɒ
àlèŋá	ɑ l ɛ ŋ ɑ
íŋɔ̀	i ŋ ɒ
ŋídɔ̀t̪ɔ́	ŋ i d ɒ t ɒ
nə̀ǹɔ́	n ə n ɒ
jə̀ɽà	j ə ɹ ɑ
jɛ́àɽó	j ɛ ɑ ɹ ow
lálèŋɛ̀	l ɑ l ɛ ŋ ɛ
làpìnɔ̀	l ɑ p i n ɒ
r̀ɽò	ɹ ɹ ow
nʊ̀mɔ́	n ʊ m ɒ
gʊ̀bʊ́lɔ̀	ɡ ʊ b ʊ l ɒ
àɽà	ɑ ɹ ɑ
àlkúrcì	ɑ l k ʉ ɹ tʃ i
álpʊ́ɾɔ́	ɑ l p ʊ ɾ ɒ
nálpʊ́ɾɔ́	n ɑ l p ʊ ɾ ɒ
ŋàrðá	ŋ ɑ ɹ ð ɑ
lúgɔ́	l ʉ ɡ ɒ
rúmɔ̀	ɹ ʉ m ɒ
lə̀və̀lɛ̀ðɔ́	l ə v ə l ɛ ð ɒ
ùɽcí	ʉ ɹ tʃ i
lə̀dɔ̀ŋðɔ́	l ə d ɒ ŋ ð ɒ
lə̀kə̀lcí	l ə k ə l tʃ i
ávɟìgɛ́	ɑ v dʒ i ɡ ɛ
ŋárðɔ́	ŋ ɑ ɹ ð ɒ
nɔ̀nɔ́	n ɒ n ɒ
lə̀ŋàrðɔ́	l ə ŋ ɑ ɹ ð ɒ
ŋárðɛ̀	ŋ ɑ ɹ ð ɛ
ŋárðà	ŋ ɑ ɹ ð ɑ
ŋàrðɔ́	ŋ ɑ ɹ ð ɒ
lùɽcí	l ʉ ɹ tʃ i
úɽcì	ʉ ɹ tʃ i
lúɽcà	l ʉ ɹ tʃ ɑ
nɛ̀làɽà	n ɛ l ɑ ɹ ɑ
ájàŋá	ɑ j ɑ ŋ ɑ
nàlbàcʊ̂m	n ɑ l b ɑ tʃ ʊ m
ŋùdòɾèɲà	ŋ ʉ d ow ɾ ɛ ɲ ɑ
ŋèdé	ŋ ɛ d ɛ
ŋèdéɲá	ŋ ɛ d ɛ ɲ ɑ
ɲúɽî	ɲ ʉ ɹ i
ŋúɽíɲɛ́	ŋ ʉ ɹ i ɲ ɛ
ɲúɽíɲɛ́	ɲ ʉ ɹ i ɲ ɛ
àlmúndù	ɑ l m ʉ n d ʉ
nàlmúndù	n ɑ l m ʉ n d ʉ
nàlmúnd̪ɔ̀	n ɑ l m ʉ n d ɒ
lídɔ́	l i d ɒ
ŋídɔ́	ŋ i d ɒ
ɲìðɛ̀ní	ɲ i ð ɛ n i
ŋìðɛ̀nɔ́	ŋ i ð ɛ n ɒ
ɲìðɛ̀nɔ́	ɲ i ð ɛ n ɒ
rúmáɲà	ɹ ʉ m ɑ ɲ ɑ
ìt̪ə̀lɔ́	i t ə l ɒ
ìndò	i n d ow
ìlŋìnɔ̀	i l ŋ i n ɒ
lìŋìnɔ̀	l i ŋ i n ɒ
nə̀ŋná	n ə ŋ n ɑ
ńdrí	n d ɹ i
ŋə̀t̪ɾì	ŋ ə t ɾ i
ŋə̀t̪ɾɔ̀	ŋ ə t ɾ ɒ
ŋárɔ́	ŋ ɑ ɹ ɒ
làvàrà	l ɑ v ɑ ɹ ɑ
nɛ́ɾɛ́	n ɛ ɾ ɛ
nɛ́ɾá	n ɛ ɾ ɑ
ŋàvàrà	ŋ ɑ v ɑ ɹ ɑ
lípíjɔ́	l i p i j ɒ
lə̀màð	l ə m ɑ ð
ɛ́lê	ɛ l ɛ
níɾí	n i ɾ i
ɛ̀ɾɛ̀ð	ɛ ɾ ɛ ð
ŋə̀mà	ŋ ə m ɑ
ŋùɾìjɔ́	ŋ ʉ ɾ i j ɒ
lòɾá	l ow ɾ ɑ
ŋʊ̀tú	ŋ ʊ t ʉ
nàlkârɔ̀	n ɑ l k ɑ ɹ ɒ
lán	l ɑ n
lácɔ́	l ɑ tʃ ɒ
ŋácɔ́	ŋ ɑ tʃ ɒ
ìŋɔ̀	i ŋ ɒ
ŋtá	ŋ t ɑ
lùtùwɔ̀	l ʉ t ʉ w ɒ
ʊ̀mì	ʊ m i
ùlɔ́	ʉ l ɒ
lajlɛ́n	l ɑ j l ɛ n
lùɾìjɔ́	l ʉ ɾ i j ɒ
ŋíjɔ́	ŋ i j ɒ
lrɔ̂bà	l ɹ ɒ b ɑ
ðràvì	ð ɹ ɑ v i
nàdám	n ɑ d ɑ m
nàdámá	n ɑ d ɑ m ɑ
ámálá	ɑ m ɑ l ɑ
nɛ̀mbré	n ɛ m b ɹ ɛ
lə̀mbrá	l ə m b ɹ ɑ
ŋə̀mbrá	ŋ ə m b ɹ ɑ
ŋùlá	ŋ ʉ l ɑ
ɔ̀ɽàt̪à	ɒ ɹ ɑ t ɑ
ɔ̀ɾì	ɒ ɾ i
ɔ́j	ɒ j
àdámá	ɑ d ɑ m ɑ
nʊ̀mì	n ʊ m i
jɔ̂ɾà	j ɒ ɾ ɑ
ðɔ̂ɾà	ð ɒ ɾ ɑ
ðə̀láɽá	ð ə l ɑ ɹ ɑ
ðə́máɽðá	ð ə m ɑ ɹ ð ɑ
kíjɔ́	k i j ɒ
kíjɔ́ŋ	k i j ɒ ŋ
ðìjɔ́	ð i j ɒ
ɔ́lá	ɒ l ɑ
kə̀nɔ̀nɔ́	k ə n ɒ n ɒ
lɜ̀ndì	l ɐ n d i
lɛ̀rá	l ɛ ɹ ɑ
ŋɛ̀rá	ŋ ɛ ɹ ɑ
ŋə̀və́r	ŋ ə v ə ɹ
lə̀və́rá	l ə v ə ɹ ɑ
ŋə̀və́rá	ŋ ə v ə ɹ ɑ
lùbút̪ú	l ʉ b ʉ t ʉ
lə̀mɔ̀ðá	l ə m ɒ ð ɑ
ŋɔ̀mɔ̀ðá	ŋ ɒ m ɒ ð ɑ
ɔ̀mná	ɒ m n ɑ
ŋàɾɛ̀	ŋ ɑ ɾ ɛ
ŋʊ̀tòsò	ŋ ʊ t ow s ow
tòsà	t ow s ɑ
ŋʊ̀tòsà	ŋ ʊ t ow s ɑ
àdə̀ɽɔ̀l	ɑ d ə ɹ ɒ l
ádə́ɽɔ́lɛ́	ɑ d ə ɹ ɒ l ɛ
édə́ɽɔ́lɛ́	ɛ d ə ɹ ɒ l ɛ
ŋə̀mɔ́ð	ŋ ə m ɒ ð
àt̪ùɟájɛ́	ɑ t ʉ dʒ ɑ j ɛ
nàt̪ùɟájɛ́	n ɑ t ʉ dʒ ɑ j ɛ
nàúɾɛ́	n ɑ ʉ ɾ ɛ
nàjén	n ɑ j ɛ n
àjènɛ́	ɑ j ɛ n ɛ
nɔ̀mná	n ɒ m n ɑ
nɜ́ɾú	n ɐ ɾ ʉ
ɛ́ɾɛ́	ɛ ɾ ɛ
ðàlgàrájɛ́	ð ɑ l ɡ ɑ ɹ ɑ j ɛ
ðìt̪rɔ́	ð i t ɹ ɒ
ðìt̪ɾɛ́	ð i t ɾ ɛ
ðɔ̀ɽár	ð ɒ ɹ ɑ ɹ
ðɔ̀ɽárɛ́	ð ɒ ɹ ɑ ɹ ɛ
làɾánɛ́	l ɑ ɾ ɑ n ɛ
nàjèné	n ɑ j ɛ n ɛ
ájìnɛ̀	ɑ j i n ɛ
ɛ̀ɾâð	ɛ ɾ ɑ ð
ǹdrâð	n d ɹ ɑ ð
ɛ̀ɾáðɛ́	ɛ ɾ ɑ ð ɛ
ndráðɛ́	n d ɹ ɑ ð ɛ
ŋɔ́mɔ́n	ŋ ɒ m ɒ n
lɔ́mɔ́nɛ́	l ɒ m ɒ n ɛ
ŋɔ́mɔ́nɛ́	ŋ ɒ m ɒ n ɛ
ìt̪ə̀ɾɔ́	i t ə ɾ ɒ
t̪ɔ́ɾɛ̀	t ɒ ɾ ɛ
lìt̪átɛ́	l i t ɑ t ɛ
ɲɛ́nɛ̀	ɲ ɛ n ɛ
ŋàɾánɛ́	ŋ ɑ ɾ ɑ n ɛ
lɛ́ɲ	l ɛ ɲ
lɛ́ɲɛ́	l ɛ ɲ ɛ
ŋgáŋâl	ŋ ɡ ɑ ŋ ɑ l
làŋə́ĺ	l ɑ ŋ ə l
lə́cə̀là	l ə tʃ ə l ɑ
òɽùwɛ́lɛ́	ow ɹ ʉ w ɛ l ɛ
kájìt̪ɔ̀	k ɑ j i t ɒ
ŋúɽɟɛ́nɛ́	ŋ ʉ ɹ dʒ ɛ n ɛ
ŋə̀ɾímɛ́	ŋ ə ɾ i m ɛ
láɾɛ̀	l ɑ ɾ ɛ
òɽùwɛ́l	ow ɹ ʉ w ɛ l
lòtùwɛ́l	l ow t ʉ w ɛ l
ɔ́rɔ̂ð	ɒ ɹ ɒ ð
ɔ́ɾɔ́ðɛ́	ɒ ɾ ɒ ð ɛ
nújɛ̀l	n ʉ j ɛ l
ŋùɽɟɛ̀n	ŋ ʉ ɹ dʒ ɛ n
ɔ́ŋɔ́ŋɔ́nɔ́	ɒ ŋ ɒ ŋ ɒ n ɒ
ɔ̀ŋɔ̀ŋɔ̀nɔ́	ɒ ŋ ɒ ŋ ɒ n ɒ
làŋìŋnú	l ɑ ŋ i ŋ n ʉ
lɔ̀ŋɔ̀ŋɔ̀nɔ́	l ɒ ŋ ɒ ŋ ɒ n ɒ
náŋúŋnɛ́	n ɑ ŋ ʉ ŋ n ɛ
t̪ə̀mànà	t ə m ɑ n ɑ
lə̀ɾàcà	l ə ɾ ɑ tʃ ɑ
ɔ́ŋɔ̀ŋɔ̀nɛ̀	ɒ ŋ ɒ ŋ ɒ n ɛ
ŋát̪à	ŋ ɑ t ɑ
ŋʊ̀cɔ̀	ŋ ʊ tʃ ɒ
ŋàt̪ɔ́	ŋ ɑ t ɒ
ŋát̪ɔ́	ŋ ɑ t ɒ
ɲìcò	ɲ i tʃ ow
ŋát̪ìt̪ɔ̀	ŋ ɑ t i t ɒ
lə̀r̀nà	l ə ɹ n ɑ
ðóɾó	ð ow ɾ ow
ðɔ́ɾɛ̀	ð ɒ ɾ ɛ
ŋíðɛ̀ní	ŋ i ð ɛ n i
ŋə́ré	ŋ ə ɹ ɛ
ŋə̀ré	ŋ ə ɹ ɛ
érnà	ɛ ɹ n ɑ
nə́ràt̪à	n ə ɹ ɑ t ɑ
ɲáìbí	ɲ ɑ i b i
t̪ə̀nɔ̀nɔ́ŋú	t ə n ɒ n ɒ ŋ ʉ
t̪ə̀nɔ̀nɛ́ŋí	t ə n ɒ n ɛ ŋ i
t̪ə̀nɔ̀nɔ́ŋ	t ə n ɒ n ɒ ŋ
ŋát̪ìðìjɔ̀	ŋ ɑ t i ð i j ɒ
ŋàt̪ìðìjí	ŋ ɑ t i ð i j i
ŋát̪ìjɔ̀	ŋ ɑ t i j ɒ
ðídìt̪ɔ́l	ð i d i t ɒ l
ðə̀ɽà	ð ə ɹ ɑ
jádìjà	j ɑ d i j ɑ
lálɛ́	l ɑ l ɛ
ŋə̀nɔ̀nɔ́	ŋ ə n ɒ n ɒ
t̪àwà	t ɑ w ɑ
t̪ə́nɔ̀nɔ́	t ə n ɒ n ɒ
kɔ́cɔ̀	k ɒ tʃ ɒ
lúcɔ́	l ʉ tʃ ɒ
ðə́máná	ð ə m ɑ n ɑ
ɔ́mná	ɒ m n ɑ
ðídíjɔ́	ð i d i j ɒ
ǹdrí	n d ɹ i
láɾân	l ɑ ɾ ɑ n
kéɲɔ́	k ɛ ɲ ɒ
àmàcá	ɑ m ɑ tʃ ɑ
làmàcí	l ɑ m ɑ tʃ i
lámàcí	l ɑ m ɑ tʃ i
lámàcà	l ɑ m ɑ tʃ ɑ
kə̀bùlìjíŋí	k ə b ʉ l i j i ŋ i
kə̀bùlìjáŋá	k ə b ʉ l i j ɑ ŋ ɑ
lə̀lɛ̀ŋcí	l ə l ɛ ŋ tʃ i
lávə̀ðàcì	l ɑ v ə ð ɑ tʃ i
lávə̀ðàcà	l ɑ v ə ð ɑ tʃ ɑ
lávə̀ðàcí	l ɑ v ə ð ɑ tʃ i
lə̀bìɽɔ́	l ə b i ɹ ɒ
bíɽɛ̀	b i ɹ ɛ
bíɽɔ̀	b i ɹ ɒ
bìɽɔ́	b i ɹ ɒ
t̪ìðɔ̀	t i ð ɒ
lə̀kèɲɔ́	l ə k ɛ ɲ ɒ
kéɲɛ̀	k ɛ ɲ ɛ
kèɲɔ́	k ɛ ɲ ɒ
lə̀ŋàt̪ɔ́	l ə ŋ ɑ t ɒ
ɛ́ɾáðɛ́	ɛ ɾ ɑ ð ɛ
rî	ɹ i
ŋâ	ŋ ɑ
ŋə́nɔ̀nɔ́	ŋ ə n ɒ n ɒ
ŋàt̪ìt̪ɔ́	ŋ ɑ t i t ɒ
ŋát̪ìðìt̪ɔ̀	ŋ ɑ t i ð i t ɒ
ávə́ðácí	ɑ v ə ð ɑ tʃ i
àvə̀ðàcá	ɑ v ə ð ɑ tʃ ɑ
làvə̀ðàcí	l ɑ v ə ð ɑ tʃ i
jámìɲí	j ɑ m i ɲ i
ðíɲɔ̀	ð i ɲ ɒ
áɽíðú	ɑ ɹ i ð ʉ
àɽìðá	ɑ ɹ i ð ɑ
làɽìðú	l ɑ ɹ i ð ʉ
láɽìðì	l ɑ ɹ i ð i
kɛ̀rdógɛ́	k ɛ ɹ d ow ɡ ɛ
kɔ́dɔ́gɛ́	k ɒ d ɒ ɡ ɛ
kàrŋ̀íŋì	k ɑ ɹ ŋ i ŋ i
kàɾt̪ìŋjú	k ɑ ɾ t i ŋ j ʉ
ɔ̀ndì	ɒ n d i
ŋə̀ǹdì	ŋ ə n d i
kə̀bùlìjíŋ	k ə b ʉ l i j i ŋ
kə̀bùlìjɜ́l	k ə b ʉ l i j ɐ l
lə̀t̪ɔ̀ɽɔ́	l ə t ɒ ɹ ɒ
t̪ɔ́ɽɛ̀	t ɒ ɹ ɛ
t̪ɔ́ɽà	t ɒ ɹ ɑ
t̪ɔ̀ɽɔ́	t ɒ ɹ ɒ
lə̀t̪ɔ̀t̪ɔ́	l ə t ɒ t ɒ
ðɔ̀ɽiŋ̀t̪úl	ð ɒ ɹ i ŋ t ʉ l
t̪ɔ́t̪à	t ɒ t ɑ
lə́t̪ɔ̀t̪à	l ə t ɒ t ɑ
lə́t̪ɔ̀t̪ɔ́	l ə t ɒ t ɒ
t̪ɔ̀t̪ɔ́	t ɒ t ɒ
úmɔ́ðɔ́	ʉ m ɒ ð ɒ
ùmɔ̀ðɔ́	ʉ m ɒ ð ɒ
lùmɔ̀ðɔ́	l ʉ m ɒ ð ɒ
úmɛ̀ðɛ̀	ʉ m ɛ ð ɛ
úmɔ̀ðɔ̀	ʉ m ɒ ð ɒ
lə̀vàɾɔ́	l ə v ɑ ɾ ɒ
váɾà	v ɑ ɾ ɑ
vàɾɔ́	v ɑ ɾ ɒ
t̪ɔ́t̪ɛ̀	t ɒ t ɛ
láɽìðà	l ɑ ɹ i ð ɑ
láɽìðú	l ɑ ɹ i ð ʉ
muðɔ	m ʉ ð ɒ
kə́ðìɲɔ̀	k ə ð i ɲ ɒ
ŋə̀ðìɲí	ŋ ə ð i ɲ i
út̪ìðì	ʉ t i ð i
jə́dɔ̀ŋðáŋà	j ə d ɒ ŋ ð ɑ ŋ ɑ
ŋìðìnɔ́ŋú	ŋ i ð i n ɒ ŋ ʉ
ádɔ̀ŋðɔ́íŋì	ɑ d ɒ ŋ ð ɒ i ŋ i
ŋáŋàt̪à	ŋ ɑ ŋ ɑ t ɑ
àɾá	ɑ ɾ ɑ
ŋáŋàt̪á	ŋ ɑ ŋ ɑ t ɑ
ŋàvt̪ɔ́	ŋ ɑ v t ɒ
áɾà	ɑ ɾ ɑ
kìblɔ́ŋú	k i b l ɒ ŋ ʉ
ŋə́ðáŋàl	ŋ ə ð ɑ ŋ ɑ l
t̪ɜ̀dí	t ɐ d i
ðɜ̀ríbɔ̀	ð ɐ ɹ i b ɒ
ðóẁ	ð ow w
làɾà	l ɑ ɾ ɑ
kɛ́ɾìjí	k ɛ ɾ i j i
ŋə́ɽɛ́jŋð̀àŋàl	ŋ ə ɹ ɛ j ŋ ð ɑ ŋ ɑ l
kɔ̀ɽáló	k ɒ ɹ ɑ l ow
kə̀ɽàɲìðú	k ə ɹ ɑ ɲ i ð ʉ
kə̀ɽà	k ə ɹ ɑ
káɽə̀ŋàt̪ɔ́l	k ɑ ɹ ə ŋ ɑ t ɒ l
t̪ìbíŋì	t i b i ŋ i
t̪ìbíŋí	t i b i ŋ i
vŕðɔ́	v ɹ ð ɒ
nə́t̪ìðíŋì	n ə t i ð i ŋ i
kɔ́ðà	k ɒ ð ɑ
mɛ́ðàt̪á	m ɛ ð ɑ t ɑ
nɛ̀ðɔ́	n ɛ ð ɒ
mɛ́ðát̪ɔ́	m ɛ ð ɑ t ɒ
nɔ̀dɔ̀	n ɒ d ɒ
ɛ́ðúŋ	ɛ ð ʉ ŋ
kíðɔ́l	k i ð ɒ l
pìɽɔ́	p i ɹ ɒ
ŋìbìnɔ̀	ŋ i b i n ɒ
kíbilɔ́ŋ̀nú	k i b i l ɒ ŋ n ʉ
ɲɔ̂n	ɲ ɒ n
t̪ɜ́díŋ	t ɐ d i ŋ
ŋə́màt̪ɛ̀	ŋ ə m ɑ t ɛ
ŋə́mìɲàt̪ɛ̀	ŋ ə m i ɲ ɑ t ɛ
ŋə́mɛ̀ðàt̪ɛ̀	ŋ ə m ɛ ð ɑ t ɛ
nɜ̀ðú	n ɐ ð ʉ
kə̀bùlìjíl	k ə b ʉ l i j i l
làdɔ̀ŋɔ̀nɛ̀	l ɑ d ɒ ŋ ɒ n ɛ
nìðìnɔ́ŋú	n i ð i n ɒ ŋ ʉ
jídɔ̀ŋt̪ú	j i d ɒ ŋ t ʉ
kə̀bùlìjátɛ́	k ə b ʉ l i j ɑ t ɛ
kə̀bùlìjátɛ́ŕ	k ə b ʉ l i j ɑ t ɛ ɹ
kə̀bùlìjéɲárɛ́	k ə b ʉ l i j ɛ ɲ ɑ ɹ ɛ
kə̀bùlìjɜ́llíŕ	k ə b ʉ l i j ɐ l l i ɹ
kə̀bùlìjáɲà	k ə b ʉ l i j ɑ ɲ ɑ
kə̀bùlìjáɲá	k ə b ʉ l i j ɑ ɲ ɑ
kə́jɛ̀ðɛ̀	k ə j ɛ ð ɛ
kə̀bùlìjáŋà	k ə b ʉ l i j ɑ ŋ ɑ
vɔ́ðɔ̀	v ɒ ð ɒ
jáŋúl	j ɑ ŋ ʉ l
lə̀bùlìjíl	l ə b ʉ l i j i l
t̪ə́màt̪à	t ə m ɑ t ɑ
lə́vàvɾà	l ə v ɑ v ɾ ɑ
lùrmùðɔ̀	l ʉ ɹ m ʉ ð ɒ
ðáɽìðì	ð ɑ ɹ i ð i
kɔ́dɔ̀ŋɔ̀nɔ́	k ɒ d ɒ ŋ ɒ n ɒ
kə́dɔ̀ŋðɔ́	k ə d ɒ ŋ ð ɒ
kə̀bɽánànǒ	k ə b ɹ ɑ n ɑ n ow
kə̀mànìnɔ̀	k ə m ɑ n i n ɒ
kə́ðìɲìjí	k ə ð i ɲ i j i
jít̪ɔ́	j i t ɒ
lə́lɔ̀ɽà	l ə l ɒ ɹ ɑ
lɔ́ɽá	l ɒ ɹ ɑ
kə̀r̀nà	k ə ɹ n ɑ
jájàt̪à	j ɑ j ɑ t ɑ
kɔ̀dɔ̀ŋɔ̀nɔ́	k ɒ d ɒ ŋ ɒ n ɒ
ðə́míɲá	ð ə m i ɲ ɑ
ɲàðàt̪ɔ́	ɲ ɑ ð ɑ t ɒ
ɔ́nt̪ɔ̀	ɒ n t ɒ
ɔ́nt̪ɔ́	ɒ n t ɒ
t̪ə́mànú	t ə m ɑ n ʉ
kìbìnáló	k i b i n ɑ l ow
kə́dɔ̀ŋðɛ̀	k ə d ɒ ŋ ð ɛ
lùmìnɔ̀	l ʉ m i n ɒ
lùmìnɔ́	l ʉ m i n ɒ
ŋìjɔ́	ŋ i j ɒ
lòðì	l ow ð i
jə́t̪ìjí	j ə t i j i
ɲɛ́nɛ́	ɲ ɛ n ɛ
ŕà	ɹ ɑ
ɛ̀vàɾtɔ̀	ɛ v ɑ ɾ t ɒ
náŋìt̪ɛ̀	n ɑ ŋ i t ɛ
jíjìnɔ̀	j i j i n ɒ
ŋə̀pɔ́	ŋ ə p ɒ
ŋòðà	ŋ ow ð ɑ
làŋmìɲú	l ɑ ŋ m i ɲ ʉ
lə́làɽà	l ə l ɑ ɹ ɑ
t̪ánt̪ɛ̀	t ɑ n t ɛ
ðábúðá	ð ɑ b ʉ ð ɑ
ðúrɔ̀	ð ʉ ɹ ɒ
ðúrɔ́	ð ʉ ɹ ɒ
ðə́ŕlɔ́ɲɔ́	ð ə ɹ l ɒ ɲ ɒ
kùrŋú	k ʉ ɹ ŋ ʉ
ðùdì	ð ʉ d i
kɔ̀dɔ́	k ɒ d ɒ
lə̀və̀lɛ̀ðɛ̀	l ə v ə l ɛ ð ɛ
kə̀pɔ́	k ə p ɒ
ðə̀bùlìjí	ð ə b ʉ l i j i
àɾðɔ́	ɑ ɾ ð ɒ
kə̀vr̀ðɔ́	k ə v ɹ ð ɒ
kə̀rŋìt̪ú	k ə ɹ ŋ i t ʉ
kárŋìt̪ɔ̀	k ɑ ɹ ŋ i t ɒ
kárŋìt̪ɔ́	k ɑ ɹ ŋ i t ɒ
ákàɾŋóú	ɑ k ɑ ɾ ŋ ow ʉ
jábòt̪ɔ́	j ɑ b ow t ɒ
ðə̀pɔ́	ð ə p ɒ
ŋə̀və̀lɛ̀ðɔ́	ŋ ə v ə l ɛ ð ɒ
lùmɔ́	l ʉ m ɒ
ḿɛ̀	m ɛ
ŋùðì	ŋ ʉ ð i
kɛ́ɾɔ́	k ɛ ɾ ɒ
kɛ̀ɾá	k ɛ ɾ ɑ
ɾ̀làndá	ɾ l ɑ n d ɑ
jáŋàlà	j ɑ ŋ ɑ l ɑ
jàŋàl	j ɑ ŋ ɑ l
jə̀və̀lɛ̀ðɔ́l	j ə v ə l ɛ ð ɒ l
m̀ɔ́	m ɒ
lə̀və̀lɛ̀ðɔ́l	l ə v ə l ɛ ð ɒ l
jáŋàl	j ɑ ŋ ɑ l
jɜ̀dí	j ɐ d i
àlkúɾcɛ́	ɑ l k ʉ ɾ tʃ ɛ
ìlɔ̀ðɔ̀	i l ɒ ð ɒ
járà	j ɑ ɹ ɑ
jìt̪ɔ̀t̪ɔ́	j i t ɒ t ɒ
éd̪èɾá	ɛ d ɛ ɾ ɑ
jàló	j ɑ l ow
lótùwɛ́l	l ow t ʉ w ɛ l
ltúwɛ́lɛ́	l t ʉ w ɛ l ɛ
úɽìðì	ʉ ɹ i ð i
t̪áɽìt̪ɛ̀	t ɑ ɹ i t ɛ
ŋàcà	ŋ ɑ tʃ ɑ
mút̪ɔ́	m ʉ t ɒ
mùt̪ɔ́	m ʉ t ɒ
lə̀mùt̪ɔ́	l ə m ʉ t ɒ
mút̪ɛ̀	m ʉ t ɛ
mút̪ɔ̀	m ʉ t ɒ
ŋə̀mùt̪ɔ́l	ŋ ə m ʉ t ɒ l
lə́ɾàcí	l ə ɾ ɑ tʃ i
ŋídɔ̀t̪ɔ̀	ŋ i d ɒ t ɒ
èd̪èɾá	ɛ d ɛ ɾ ɑ
ílɔ́ðɔ́	i l ɒ ð ɒ
lə̀ɾàcí	l ə ɾ ɑ tʃ i
ɾácì	ɾ ɑ tʃ i
ɾácà	ɾ ɑ tʃ ɑ
ɾàcí	ɾ ɑ tʃ i
kàɾcá	k ɑ ɾ tʃ ɑ
ídɛ̀t̪ɛ̀	i d ɛ t ɛ
káɾcì	k ɑ ɾ tʃ i
lə̀bú	l ə b ʉ
káɾcà	k ɑ ɾ tʃ ɑ
kàɾcí	k ɑ ɾ tʃ i
álkúɾcɛ́	ɑ l k ʉ ɾ tʃ ɛ
ŋíðɛ̀t̪ɛ̀	ŋ i ð ɛ t ɛ
ðə̀mànɲà	ð ə m ɑ n ɲ ɑ
r̀mànɲà	ɹ m ɑ n ɲ ɑ
àlmúnd̪ɔ̀	ɑ l m ʉ n d ɒ
jɛ̀lírvə́lɛ̂ðɛ̌rló	j ɛ l i ɹ v ə l ɛ ð ɛ ɹ l ow
ɽìɲà	ɹ i ɲ ɑ
ŋúrɔ̀t̪ɔ́	ŋ ʉ ɹ ɒ t ɒ
ájàt̪ɔ́	ɑ j ɑ t ɒ
ŋíðìnɔ́ŋ	ŋ i ð i n ɒ ŋ
ŋùrìt̪ɛ̀	ŋ ʉ ɹ i t ɛ
t̪ə̀r̀ɔ́t̪ɛ́	t ə ɹ ɒ t ɛ
ŋə̀rìt̪ɛ̀	ŋ ə ɹ i t ɛ
ɛ́núŋ	ɛ n ʉ ŋ
ŋúɽìðì	ŋ ʉ ɹ i ð i
ájáŋ̀	ɑ j ɑ ŋ
ŋùd̪ɛ̀t̪ɛ̀	ŋ ʉ d ɛ t ɛ
ŋʊ̀dó	ŋ ʊ d ow
ðíɲú	ð i ɲ ʉ
ðə̀ɾ̀làndɔ́	ð ə ɾ l ɑ n d ɒ
âɾò	ɑ ɾ ow
ŋɔ́ðɔ́	ŋ ɒ ð ɒ
lə̀ŋàcíŋì	l ə ŋ ɑ tʃ i ŋ i
ŋɔ́ðɛ́	ŋ ɒ ð ɛ
ŋə̀ŋàcíŋì	ŋ ə ŋ ɑ tʃ i ŋ i
làŋcíŋì	l ɑ ŋ tʃ i ŋ i
ŋàŋcí	ŋ ɑ ŋ tʃ i
ŋàŋcíŋì	ŋ ɑ ŋ tʃ i ŋ i
ŋàŋì	ŋ ɑ ŋ i
láŋì	l ɑ ŋ i
lə́nɛ̀ðɔ́	l ə n ɛ ð ɒ
ðìnɔ́	ð i n ɒ
nɛ́ðà	n ɛ ð ɑ
ŋáŋì	ŋ ɑ ŋ i
lə́ɲɛ̀làcí	l ə ɲ ɛ l ɑ tʃ i
jàĺ	j ɑ l
lə̀nɛ̀ðɔ́	l ə n ɛ ð ɒ
ðínɔ́	ð i n ɒ
nɛ́ðɛ̀	n ɛ ð ɛ
ájàŕ	ɑ j ɑ ɹ
bàcʊ́mɛ́	b ɑ tʃ ʊ m ɛ
nàlbàcʊ́mɛ́	n ɑ l b ɑ tʃ ʊ m ɛ
nálpúɾɔ́	n ɑ l p ʉ ɾ ɒ
nàŋná	n ɑ ŋ n ɑ
nàlcʊ̀mú	n ɑ l tʃ ʊ m ʉ
dúnŋù	d ʉ n ŋ ʉ
nɛ̀lɛ̀	n ɛ l ɛ
ɛ́lɔ́ŋú	ɛ l ɒ ŋ ʉ
nɛ́lé	n ɛ l ɛ
ɛ̀màðàló	ɛ m ɑ ð ɑ l ow
nɛ́léɲé	n ɛ l ɛ ɲ ɛ
náɾàt̪ɛ̀	n ɑ ɾ ɑ t ɛ
nɛ́ðɔ́	n ɛ ð ɒ
ðínɔ̀	ð i n ɒ
nɛ̀ðá	n ɛ ð ɑ
nìlí	n i l i
émàð	ɛ m ɑ ð
vɜ́ɽínɔ́	v ɐ ɹ i n ɒ
ját̪ɛ̀	j ɑ t ɛ
ŋídɛ̀t̪ɛ̀	ŋ i d ɛ t ɛ
ńdó	n d ow
írí	i ɹ i
nírí	n i ɹ i
nìt̪ìlɔ́	n i t i l ɒ
lə̀vàrà	l ə v ɑ ɹ ɑ
ŋə̀vàrà	ŋ ə v ɑ ɹ ɑ
lə̀t̪ɾɔ̀	l ə t ɾ ɒ
láŋcɛ̀cì	l ɑ ŋ tʃ ɛ tʃ i
írcə̀cì	i ɹ tʃ ə tʃ i
írcə̀cɔ̀	i ɹ tʃ ə tʃ ɒ
ðít̪ɾɛ́	ð i t ɾ ɛ
ðə̀ŋɛ̀ɾɔ̀	ð ə ŋ ɛ ɾ ɒ
èŋɛ̀ɾɔ̀	ɛ ŋ ɛ ɾ ɒ
ðə̀ŋɛ̀ɾà	ð ə ŋ ɛ ɾ ɑ
èŋɛ̀ɾà	ɛ ŋ ɛ ɾ ɑ
ðə̀d̪ùɾɔ̀t̪ɔ́	ð ə d ʉ ɾ ɒ t ɒ
vɜ̀ɽìnɔ́	v ɐ ɹ i n ɒ
lə̀ɲɛ̀làcí	l ə ɲ ɛ l ɑ tʃ i
ɲɛ́làcì	ɲ ɛ l ɑ tʃ i
ɲɛ́làcà	ɲ ɛ l ɑ tʃ ɑ
lìrcə̀cí	l i ɹ tʃ ə tʃ i
t̪àɾìt̪ɔ́	t ɑ ɾ i t ɒ
ícə̀là	i tʃ ə l ɑ
kìjàt̪áŋá	k i j ɑ t ɑ ŋ ɑ
t̪ɔ́ɾɔ́	t ɒ ɾ ɒ
ít̪rɛ́	i t ɹ ɛ
ɲɛ́lácí	ɲ ɛ l ɑ tʃ i
ɲɛ̀làcá	ɲ ɛ l ɑ tʃ ɑ
gɔ̂n	ɡ ɒ n
ŋə̀jàjɔ́	ŋ ə j ɑ j ɒ
ɲɛ̀làcí	ɲ ɛ l ɑ tʃ i
lə́ɲɛ̀làcà	l ə ɲ ɛ l ɑ tʃ ɑ
nídúŋ	n i d ʉ ŋ
ŋə̀r̀ɛ̀	ŋ ə ɹ ɛ
ŋə̀t̪ɛ̀	ŋ ə t ɛ
ŋ̀tá	ŋ t ɑ
nûn	n ʉ n
lə̀t̪úŋ	l ə t ʉ ŋ
ŋùd̪ɔ́	ŋ ʉ d ɒ
ŋə̀bùrŋ̀ŋúŋɛ́	ŋ ə b ʉ ɹ ŋ ŋ ʉ ŋ ɛ
t̪ə́ɽà	t ə ɹ ɑ
t̪ìjàt̪ɔ́	t i j ɑ t ɒ
ðə́ɽà	ð ə ɹ ɑ
vɜ́ɽìnɔ́	v ɐ ɹ i n ɒ
lɔ́ɾɔ̀	l ɒ ɾ ɒ
nûltùmtánì	n ʉ l t ʉ m t ɑ n i
t̪úmɔ́	t ʉ m ɒ
lùd̪ɔ̀	l ʉ d ɒ
lɔ̀dɔ̀	l ɒ d ɒ
lʊ́dó	l ʊ d ow
nínà	n i n ɑ
ámál	ɑ m ɑ l
lùró	l ʉ ɹ ow
ŋùró	ŋ ʉ ɹ ow
ŋʊ̀mbə́ɽó	ŋ ʊ m b ə ɹ ow
ɔ́ɾíɲɛ́	ɒ ɾ i ɲ ɛ
òmì	ow m i
nòmì	n ow m i
ɲʊ̀mbə́ɽó	ɲ ʊ m b ə ɹ ow
ðə̀rɔ́	ð ə ɹ ɒ
t̪ɛ́l	t ɛ l
lɔ̀rlà	l ɒ ɹ l ɑ
lə̀və̀lɛ̀ðátɛ́ŕ	l ə v ə l ɛ ð ɑ t ɛ ɹ
kə́ŋvə̀lɛ̀ðú	k ə ŋ v ə l ɛ ð ʉ
ðràvà	ð ɹ ɑ v ɑ
ðə́láɽá	ð ə l ɑ ɹ ɑ
lə́dɔ̀ŋðɛ̀	l ə d ɒ ŋ ð ɛ
lə́t̪ɔ̀t̪ɛ̀	l ə t ɒ t ɛ
ðáɾà	ð ɑ ɾ ɑ
lə̀vr̀ðɛ̀	l ə v ɹ ð ɛ
lə̀vr̀ðɔ̀	l ə v ɹ ð ɒ
lùrɔ̀	l ʉ ɹ ɒ
lə́r̀lɛ̀ɲì	l ə ɹ l ɛ ɲ i
ðə́vɔ́ɽɔ́	ð ə v ɒ ɹ ɒ
nádám	n ɑ d ɑ m
ðə́dɔ́ŋðá	ð ə d ɒ ŋ ð ɑ
nálɛ́	n ɑ l ɛ
èdɛ̀ɽì	ɛ d ɛ ɹ i
ðàɾáló	ð ɑ ɾ ɑ l ow
lɛ̀rdì	l ɛ ɹ d i
t̪ɔ̀ɾt̪ɔ́l	t ɒ ɾ t ɒ l
lɛ̀rdà	l ɛ ɹ d ɑ
làbùðɛ̀	l ɑ b ʉ ð ɛ
lùɽcì	l ʉ ɹ tʃ i
və̀lɛ̀ðìjí	v ə l ɛ ð i j i
édɛ̀ɽì	ɛ d ɛ ɹ i
ðə́vŕðɔ́	ð ə v ɹ ð ɒ
ɲàvə̀lɛ̀ðɔ́	ɲ ɑ v ə l ɛ ð ɒ
və́lɛ̀ðìjɔ̀	v ə l ɛ ð i j ɒ
t̪áŋì	t ɑ ŋ i
və̀lɛ̀ðìjɔ́	v ə l ɛ ð i j ɒ
ðírcə́cɔ́	ð i ɹ tʃ ə tʃ ɒ
ŋìrcə̀cɔ̀	ŋ i ɹ tʃ ə tʃ ɒ
jə́və̀lɛ̀ðáló	j ə v ə l ɛ ð ɑ l ow
jɔ́rǹɔ́	j ɒ ɹ n ɒ
lə́və̀lɛ̀ðɔ́l	l ə v ə l ɛ ð ɒ l
lə́və̀lɛ̀ðáló	l ə v ə l ɛ ð ɑ l ow
lápìŋnúl	l ɑ p i ŋ n ʉ l
kə́ðìŋnúl	k ə ð i ŋ n ʉ l
ɛ́nɔ̌	ɛ n ɒ
nɔ̀rǹɔ́	n ɒ ɹ n ɒ
lùɽcà	l ʉ ɹ tʃ ɑ
ŋíðɔ̀	ŋ i ð ɒ
ɜ́nì	ɐ n i
lə̀ŋàŋɛ̀	l ə ŋ ɑ ŋ ɛ
lə̀ŋàŋà	l ə ŋ ɑ ŋ ɑ
àɾt̪ìjí	ɑ ɾ t i j i
ðɛ́rdà	ð ɛ ɹ d ɑ
làwó	l ɑ w ow
láwì	l ɑ w i
láwà	l ɑ w ɑ
áɾt̪ínɔ́	ɑ ɾ t i n ɒ
lə̀wàjì	l ə w ɑ j i
lə̀wàjà	l ə w ɑ j ɑ
lìrcɛ̀cɔ̀	l i ɹ tʃ ɛ tʃ ɒ
t̪ɔ̀ɾɛ̀	t ɒ ɾ ɛ
àɾt̪ìnɔ́	ɑ ɾ t i n ɒ
káɾt̪ìt̪átɛ́	k ɑ ɾ t i t ɑ t ɛ
ɲə̀və̀lɛ̀ðɛ̀	ɲ ə v ə l ɛ ð ɛ
jàɾt̪ìt̪átɛ́	j ɑ ɾ t i t ɑ t ɛ
ɲə̀və̀lɛ̀ðà	ɲ ə v ə l ɛ ð ɑ
kɔ́ɾt̪átɛ́	k ɒ ɾ t ɑ t ɛ
lə́və̀lɛ̀ðà	l ə v ə l ɛ ð ɑ
t̪ɔ̀ɾt̪átɛ́ŕ	t ɒ ɾ t ɑ t ɛ ɹ
t̪ɔ̀ɾt̪átɛ́	t ɒ ɾ t ɑ t ɛ
lə́və̀lɛ̀ðɔ́ŕ	l ə v ə l ɛ ð ɒ ɹ
áɾt̪ìnɔ́ŕ	ɑ ɾ t i n ɒ ɹ
ŋə̀və̀lɛ̀ðɛ̀	ŋ ə v ə l ɛ ð ɛ
ðə́ŋáŋá	ð ə ŋ ɑ ŋ ɑ
lə̀t̪ú	l ə t ʉ
lə̀t̪ì	l ə t i
lə̀t̪à	l ə t ɑ
ðə́t̪á	ð ə t ɑ
ðìɲɔ́	ð i ɲ ɒ
lìdú	l i d ʉ
ìdú	i d ʉ
lìdɔ̀	l i d ɒ
ŋə̀və̀lɛ̀ðà	ŋ ə v ə l ɛ ð ɑ
nə̀və̀lɛ̀ðɛ̀	n ə v ə l ɛ ð ɛ
lə́jɔ́ŕ	l ə j ɒ ɹ
ɲájɔ́	ɲ ɑ j ɒ
néɲá	n ɛ ɲ ɑ
lɜ́ðɜ̀ŋìnɔ́l	l ɐ ð ɐ ŋ i n ɒ l
láŋáŋà	l ɑ ŋ ɑ ŋ ɑ
lə́d̪ùɾɔ̀	l ə d ʉ ɾ ɒ
ðáwá	ð ɑ w ɑ
kə́r̀lɛ̀ɲígɛ́	k ə ɹ l ɛ ɲ i ɡ ɛ
lə̀və̀lɛ̀ðɔ́ŋúl	l ə v ə l ɛ ð ɒ ŋ ʉ l
kə̀və̀lɛ̀ðɛ̀	k ə v ə l ɛ ð ɛ
lə̀ŋàŋɔ́	l ə ŋ ɑ ŋ ɒ
ŋáŋɛ̀	ŋ ɑ ŋ ɛ
və́lɛ̀ðàt̪ɛ̀	v ə l ɛ ð ɑ t ɛ
lǎllóvə́lɛ̂ðàló	l ɑ l l ow v ə l ɛ ð ɑ l ow
lə̀r̀à	l ə ɹ ɑ
ðə́ŕá	ð ə ɹ ɑ
lə́dɔ̀ŋðàt̪ɛ̀	l ə d ɒ ŋ ð ɑ t ɛ
lɛ́vàɾt̪ɔ̀	l ɛ v ɑ ɾ t ɒ
lə̀t̪ìjí	l ə t i j i
t̪íjì	t i j i
ðùpà	ð ʉ p ɑ
dɔ̀ŋðàt̪á	d ɒ ŋ ð ɑ t ɑ
vɾáðát̪ɔ́	v ɾ ɑ ð ɑ t ɒ
vɾàðàt̪ɔ́	v ɾ ɑ ð ɑ t ɒ
ábúðát̪ɔ́	ɑ b ʉ ð ɑ t ɒ
kə́lcácí	k ə l tʃ ɑ tʃ i
kə̀lcàcá	k ə l tʃ ɑ tʃ ɑ
və́lɛ́ðát̪ɔ́	v ə l ɛ ð ɑ t ɒ
àré	ɑ ɹ ɛ
làwì	l ɑ w i
làwà	l ɑ w ɑ
ŋáŋɔ́	ŋ ɑ ŋ ɒ
ŋàŋá	ŋ ɑ ŋ ɑ
və̀lɛ̀ðàt̪á	v ə l ɛ ð ɑ t ɑ
dɔ́ŋðát̪ɔ́	d ɒ ŋ ð ɑ t ɒ
úrɔ́t̪ɔ́	ʉ ɹ ɒ t ɒ
ùrɔ̀t̪ɔ́	ʉ ɹ ɒ t ɒ
káɾát̪ɔ́	k ɑ ɾ ɑ t ɒ
lə̀mùt̪ɛ̀	l ə m ʉ t ɛ
kàɾàt̪á	k ɑ ɾ ɑ t ɑ
àɽàt̪ɔ́	ɑ ɹ ɑ t ɒ
lùrɔ̀t̪ɔ́	l ʉ ɹ ɒ t ɒ
úrɔ̀t̪ɔ̀	ʉ ɹ ɒ t ɒ
àbùðàt̪á	ɑ b ʉ ð ɑ t ɑ
lə́dɔ̀ŋðàt̪ɔ́	l ə d ɒ ŋ ð ɑ t ɒ
dɔ́ŋðàt̪à	d ɒ ŋ ð ɑ t ɑ
dɔ̀ŋðàt̪ɔ́	d ɒ ŋ ð ɑ t ɒ
úrɛ̀t̪ɛ̀	ʉ ɹ ɛ t ɛ
lə́dɔ̀ŋðàt̪à	l ə d ɒ ŋ ð ɑ t ɑ
vŕðɛ̀t̪ɛ̀	v ɹ ð ɛ t ɛ
lə̀vɾàðàt̪ɔ́	l ə v ɾ ɑ ð ɑ t ɒ
vŕðɔ̀t̪ɔ̀	v ɹ ð ɒ t ɒ
vr̀ðɔ̀t̪ɔ́	v ɹ ð ɒ t ɒ
lə̀vr̀ðɛ̀t̪ɛ̀	l ə v ɹ ð ɛ t ɛ
lə̀vɾàðàt̪ɛ̀	l ə v ɾ ɑ ð ɑ t ɛ
lə̀wàjàcí	l ə w ɑ j ɑ tʃ i
wájàcì	w ɑ j ɑ tʃ i
wájàcà	w ɑ j ɑ tʃ ɑ
wàjàcí	w ɑ j ɑ tʃ i
lə̀wàjàcì	l ə w ɑ j ɑ tʃ i
jávt̪ɔ́	j ɑ v t ɒ
ɟíðɛ́cí	dʒ i ð ɛ tʃ i
ɟìðɔ̀cɔ́	dʒ i ð ɒ tʃ ɒ
lə̀ɟìðɛ̀cí	l ə dʒ i ð ɛ tʃ i
lə̀ɟìðɛ̀cì	l ə dʒ i ð ɛ tʃ i
ɟíðɛ̀cì	dʒ i ð ɛ tʃ i
wájácí	w ɑ j ɑ tʃ i
wàjàcá	w ɑ j ɑ tʃ ɑ
lə̀ɟìðɔ̀cɔ̀	l ə dʒ i ð ɒ tʃ ɒ
ídɔ́t̪ɔ́	i d ɒ t ɒ
ìdɔ̀t̪ɔ́	i d ɒ t ɒ
lə̀wàjàcà	l ə w ɑ j ɑ tʃ ɑ
lìdɛ̀t̪ɛ̀	l i d ɛ t ɛ
lìdɔ̀t̪ɔ̀	l i d ɒ t ɒ
lɔ̀t̪ɔ́	l ɒ t ɒ
lə́ɟìðɔ̀cɔ̀	l ə dʒ i ð ɒ tʃ ɒ
ɟìðɛ̀cí	dʒ i ð ɛ tʃ i
vàràt̪á	v ɑ ɹ ɑ t ɑ
lə̀vàràt̪ɔ́	l ə v ɑ ɹ ɑ t ɒ
váràt̪ɛ̀	v ɑ ɹ ɑ t ɛ
ðál	ð ɑ l
lút̪ú	l ʉ t ʉ
lə̀vàràt̪à	l ə v ɑ ɹ ɑ t ɑ
ŋɔ̀t̪ɔ́	ŋ ɒ t ɒ
várú	v ɑ ɹ ʉ
váràt̪à	v ɑ ɹ ɑ t ɑ
vàràt̪ɔ́	v ɑ ɹ ɑ t ɒ
lə̀vàràt̪ɛ̀	l ə v ɑ ɹ ɑ t ɛ
lɔ̀ɽìt̪ɔ́	l ɒ ɹ i t ɒ
ɔ́ɽít̪ɔ́	ɒ ɹ i t ɒ
lə́ɔ̀ɽìt̪ɔ́	l ə ɒ ɹ i t ɒ
láɽìt̪ɛ̀	l ɑ ɹ i t ɛ
láɽìt̪ɔ́	l ɑ ɹ i t ɒ
ðə́d̪úɾɔ́	ð ə d ʉ ɾ ɒ
kɔ́ɽɜ́l	k ɒ ɹ ɐ l
ŋúɽìðà	ŋ ʉ ɹ i ð ɑ
ðálgàrâj	ð ɑ l ɡ ɑ ɹ ɑ j
náðàlgàrâj	n ɑ ð ɑ l ɡ ɑ ɹ ɑ j
ɲìmbɽá	ɲ i m b ɹ ɑ
ímbɽá	i m b ɹ ɑ
númɔ́	n ʉ m ɒ
rɔ̀mɔ̀cɔ̀	ɹ ɒ m ɒ tʃ ɒ
rɔ́mɔ̀cɔ̀	ɹ ɒ m ɒ tʃ ɒ
kɔ́ɽɛ̀	k ɒ ɹ ɛ
ŋə́mt̪ɛ́ɾá	ŋ ə m t ɛ ɾ ɑ
úɽíðát̪ɔ́	ʉ ɹ i ð ɑ t ɒ
lùɽìðàt̪ɔ́	l ʉ ɹ i ð ɑ t ɒ
ŋáɽó	ŋ ɑ ɹ ow
ŋʊ́mbə́ɽó	ŋ ʊ m b ə ɹ ow
lə̀d̪ùɾɔ̀	l ə d ʉ ɾ ɒ
ðúɽíðá	ð ʉ ɹ i ð ɑ
úɽìðà	ʉ ɹ i ð ɑ
ŋʊ́mbɛ́	ŋ ʊ m b ɛ
làɽìt̪ɔ́	l ɑ ɹ i t ɒ
ðúɽít̪ɔ́	ð ʉ ɹ i t ɒ
lùɽìðà	l ʉ ɹ i ð ɑ
lɔ̀ɽìt̪ɛ̀	l ɒ ɹ i t ɛ
ŋɔ́ɽìt̪ɛ̀	ŋ ɒ ɹ i t ɛ
ùɽìðàt̪á	ʉ ɹ i ð ɑ t ɑ
ðáló	ð ɑ l ow
t̪éɲár	t ɛ ɲ ɑ ɹ
ɲàll	ɲ ɑ l l
ðúɽíðát̪á	ð ʉ ɹ i ð ɑ t ɑ
lúɽìðàt̪à	l ʉ ɹ i ð ɑ t ɑ
lúɽìðàt̪ɛ̀	l ʉ ɹ i ð ɑ t ɛ
jáŋɛ́ló	j ɑ ŋ ɛ l ow
ðə̀və̀lɛ̀ðɔ́ŋú	ð ə v ə l ɛ ð ɒ ŋ ʉ
lǎllǔvə́lɛ̂ðǎ	l ɑ l l ʉ v ə l ɛ ð ɑ
úɽìðàt̪ɛ̀	ʉ ɹ i ð ɑ t ɛ
ùɽìðàt̪ɔ́	ʉ ɹ i ð ɑ t ɒ
ân	ɑ n
nàŋà	n ɑ ŋ ɑ
ìt̪rɛ́	i t ɹ ɛ
ðɔ̀cɔ̀	ð ɒ tʃ ɒ
ðídɔ̀t̪ɔ̀	ð i d ɒ t ɒ
lúbútɛ́	l ʉ b ʉ t ɛ
ŋúbútɛ́	ŋ ʉ b ʉ t ɛ
nàjì	n ɑ j i
ltùwɛ́lɛ́	l t ʉ w ɛ l ɛ
ùɽɟɛ́nɛ́	ʉ ɹ dʒ ɛ n ɛ
ŋùɽɟɛ́nɛ́	ŋ ʉ ɹ dʒ ɛ n ɛ
ðɔ́ɾɛ́	ð ɒ ɾ ɛ
ðɔ̀cà	ð ɒ tʃ ɑ
áǹɔ́	ɑ n ɒ
káŋáŋà	k ɑ ŋ ɑ ŋ ɑ
káŋáŋá	k ɑ ŋ ɑ ŋ ɑ
kə̀nìnɛ̀	k ə n i n ɛ
jàvt̪ɔ́	j ɑ v t ɒ
úmɔ̀	ʉ m ɒ
úd̪ɔ́	ʉ d ɒ
ðɔ̀ɽátɛ́	ð ɒ ɹ ɑ t ɛ
ápít̪íjí	ɑ p i t i j i
lùɽbí	l ʉ ɹ b i
ńdrâð	n d ɹ ɑ ð
ðìdɔ̀t̪ɔ́	ð i d ɒ t ɒ
jáɾɔ́	j ɑ ɾ ɒ
ðídɔ̀t̪ɔ́	ð i d ɒ t ɒ
ðɔ́cɔ̀	ð ɒ tʃ ɒ
ŋèðìnìt̪ɔ̀t̪ɔ̀	ŋ ɛ ð i n i t ɒ t ɒ
ápíjí	ɑ p i j i
ɛ́t̪ɛ́n	ɛ t ɛ n
káŋà	k ɑ ŋ ɑ
ðə̀kìðɔ́	ð ə k i ð ɒ
áwóŕ	ɑ w ow ɹ
ðít̪ìðɔ̀	ð i t i ð ɒ
àwóŕ	ɑ w ow ɹ
jɛ́ɾɔ̀ðɔ́	j ɛ ɾ ɒ ð ɒ
jɛ́ùɾɔ̀t̪ɔ́	j ɛ ʉ ɾ ɒ t ɒ
íŋgàló	i ŋ ɡ ɑ l ow
t̪ɛ̀	t ɛ
lɛ̀ŋgáj	l ɛ ŋ ɡ ɑ j
út̪ìt̪ɔ̀	ʉ t i t ɒ
ùt̪ìt̪ɔ́	ʉ t i t ɒ
ɾɔ́ðìt̪ìnɔ̀	ɾ ɒ ð i t i n ɒ
ɾɔ̀ðìt̪ɔ̀t̪ɔ́	ɾ ɒ ð i t ɒ t ɒ
úɟí	ʉ dʒ i
ńɛ̀	n ɛ
pít̪ìðɔ̀	p i t i ð ɒ
ùt̪ìðú	ʉ t i ð ʉ
pɔ́t̪ɔ̀	p ɒ t ɒ
jɔ́ðɛ̀	j ɒ ð ɛ
pɔ̀t̪ɔ́	p ɒ t ɒ
píðɔ̀	p i ð ɒ
píðìt̪ɔ̀	p i ð i t ɒ
pìt̪ɔ́	p i t ɒ
pìðìt̪ɔ́	p i ð i t ɒ
píðɔ̀t̪ɔ̀	p i ð ɒ t ɒ
pìðɔ̀t̪ɔ́	p i ð ɒ t ɒ
lùrɛ̀t̪ɛ̀	l ʉ ɹ ɛ t ɛ
lùrɔ̀t̪ɔ̀	l ʉ ɹ ɒ t ɒ
áɽát̪ɔ́	ɑ ɹ ɑ t ɒ
làɽàt̪ɔ́	l ɑ ɹ ɑ t ɒ
láɽàt̪ɛ̀	l ɑ ɹ ɑ t ɛ
làɽàt̪à	l ɑ ɹ ɑ t ɑ
làɽàt̪ɛ̀	l ɑ ɹ ɑ t ɛ
áŋà	ɑ ŋ ɑ
ŋə́nɛ̀ðɔ́	ŋ ə n ɛ ð ɒ
ɲájà	ɲ ɑ j ɑ
ɲájɛ̀ðɔ́	ɲ ɑ j ɛ ð ɒ
ɲàjàt̪à	ɲ ɑ j ɑ t ɑ
ɲájàt̪ɔ́	ɲ ɑ j ɑ t ɒ
ŋájà	ŋ ɑ j ɑ
ŋájú	ŋ ɑ j ʉ
jɛ́ðàt̪à	j ɛ ð ɑ t ɑ
ɲàjà	ɲ ɑ j ɑ
ɲàjìðàt̪à	ɲ ɑ j i ð ɑ t ɑ
ɲàjàt̪ìðà	ɲ ɑ j ɑ t i ð ɑ
ɲájàt̪ìðó	ɲ ɑ j ɑ t i ð ow
káŋàt̪à	k ɑ ŋ ɑ t ɑ
káŋìt̪ɛ̀	k ɑ ŋ i t ɛ
ɛ́nǎj	ɛ n ɑ j
pìðú	p i ð ʉ
láŋìðì	l ɑ ŋ i ð i
kə́r̀lɛ̀ɲì	k ə ɹ l ɛ ɲ i
kə́r̀lɛ̀ɲáŋá	k ə ɹ l ɛ ɲ ɑ ŋ ɑ
kə́r̀lɛ̀ɲáŋà	k ə ɹ l ɛ ɲ ɑ ŋ ɑ
ràjúŋrɛ́	ɹ ɑ j ʉ ŋ ɹ ɛ
nálól	n ɑ l ow l
láŋìðàt̪ɔ́	l ɑ ŋ i ð ɑ t ɒ
láŋít̪ɔ́	l ɑ ŋ i t ɒ
làŋɾìðú	l ɑ ŋ ɾ i ð ʉ
láŋìt̪ìðú	l ɑ ŋ i t i ð ʉ
kɔ́ŋcɔ̀	k ɒ ŋ tʃ ɒ
làŋìðú	l ɑ ŋ i ð ʉ
lɔ́ŋcɔ̀	l ɒ ŋ tʃ ɒ
láŋcí	l ɑ ŋ tʃ i
kɔ̀ɾɔ́ŋú	k ɒ ɾ ɒ ŋ ʉ
láŋàt̪à	l ɑ ŋ ɑ t ɑ
ŋíðìnɔ̀	ŋ i ð i n ɒ
ŋèðìnɔ̀	ŋ ɛ ð i n ɒ
ɲàmɛ̀ɾðɔ́	ɲ ɑ m ɛ ɾ ð ɒ
kə̀mɛ̀ɾðɔ́	k ə m ɛ ɾ ð ɒ
t̪ùdì	t ʉ d i
kə̀pɔ̀t̪ɔ́	k ə p ɒ t ɒ
ɲàtɛ́	ɲ ɑ t ɛ
ɲàwì	ɲ ɑ w i
láŋìðà	l ɑ ŋ i ð ɑ
láŋìðú	l ɑ ŋ i ð ʉ
làŋìt̪ɔ́	l ɑ ŋ i t ɒ
jèðìŋnìnú	j ɛ ð i ŋ n i n ʉ
jèðìnáló	j ɛ ð i n ɑ l ow
káŋɛ̂	k ɑ ŋ ɛ
kéðìnɔ́l	k ɛ ð i n ɒ l
kápìðà	k ɑ p i ð ɑ
káŋì	k ɑ ŋ i
káŋâ	k ɑ ŋ ɑ
ŋə́jɔ́ŋ	ŋ ə j ɒ ŋ
kə̀rùŋɔ̀t̪ɔ́	k ə ɹ ʉ ŋ ɒ t ɒ
rúŋìt̪ɛ̀	ɹ ʉ ŋ i t ɛ
kàpɔ́	k ɑ p ɒ
kàpìðó	k ɑ p i ð ow
ŋáɾŋìt̪ú	ŋ ɑ ɾ ŋ i t ʉ
t̪ə́mɛ̀ɾðà	t ə m ɛ ɾ ð ɑ
lə́mɛ̀ɾðà	l ə m ɛ ɾ ð ɑ
jâj	j ɑ j
kàɾɛ́ŋí	k ɑ ɾ ɛ ŋ i
kápìðì	k ɑ p i ð i
t̪ə̀ðɔ́	t ə ð ɒ
kàɾðɔ́gɛ́	k ɑ ɾ ð ɒ ɡ ɛ
jájɛ́	j ɑ j ɛ
àɾðá	ɑ ɾ ð ɑ
kàɾcìðú	k ɑ ɾ tʃ i ð ʉ
ŋə́kàɾcìðú	ŋ ə k ɑ ɾ tʃ i ð ʉ
ŋə́kàɾcìðà	ŋ ə k ɑ ɾ tʃ i ð ɑ
káɾcìðì	k ɑ ɾ tʃ i ð i
kùtìðìðú	k ʉ t i ð i ð ʉ
útìðìðì	ʉ t i ð i ð i
útìðìðɔ̀	ʉ t i ð i ð ɒ
kə́ŋàcí	k ə ŋ ɑ tʃ i
ŋácìnɛ̀	ŋ ɑ tʃ i n ɛ
káɾcìðà	k ɑ ɾ tʃ i ð ɑ
kə̀pìðɔ̀t̪ɔ́	k ə p i ð ɒ t ɒ
ìðìðú	i ð i ð ʉ
íðìðì	i ð i ð i
jàŋcɛ̀cí	j ɑ ŋ tʃ ɛ tʃ i
kàɾcìðàt̪ɔ́	k ɑ ɾ tʃ i ð ɑ t ɒ
káŋcì	k ɑ ŋ tʃ i
jɔ́ŋcɔ̀cɔ̀	j ɒ ŋ tʃ ɒ tʃ ɒ
jáŋcɛ̀cí	j ɑ ŋ tʃ ɛ tʃ i
kápìðó	k ɑ p i ð ow
lídɔ̀	l i d ɒ
ŋə́kàɾàt̪ɔ́	ŋ ə k ɑ ɾ ɑ t ɒ
kàɾàt̪ɔ́	k ɑ ɾ ɑ t ɒ
káɾàt̪ɛ̀	k ɑ ɾ ɑ t ɛ
íŋgáŋâl	i ŋ ɡ ɑ ŋ ɑ l
t̪àɾðɔ́	t ɑ ɾ ð ɒ
jə́kàɾà	j ə k ɑ ɾ ɑ
kə́lə̀ŋìt̪ɔ́	k ə l ə ŋ i t ɒ
ɲə̀jɛ̀ðɔ́	ɲ ə j ɛ ð ɒ
àɾìðó	ɑ ɾ i ð ow
kɛ̀cí	k ɛ tʃ i
kə̀kɛ̀cìðú	k ə k ɛ tʃ i ð ʉ
kɛ́cìðɔ̀	k ɛ tʃ i ð ɒ
ɲàŋɾìðú	ɲ ɑ ŋ ɾ i ð ʉ
ɲàŋìðàt̪ɔ́	ɲ ɑ ŋ i ð ɑ t ɒ
ɲàŋt̪ɔ́ú	ɲ ɑ ŋ t ɒ ʉ
ɲàŋú	ɲ ɑ ŋ ʉ
káɾàt̪à	k ɑ ɾ ɑ t ɑ
ŋàɾìðó	ŋ ɑ ɾ i ð ow
káɾìðì	k ɑ ɾ i ð i
ùtìðìðú	ʉ t i ð i ð ʉ
ŋə́kàɾcí	ŋ ə k ɑ ɾ tʃ i
ŋə́kàɾcàcí	ŋ ə k ɑ ɾ tʃ ɑ tʃ i
ŋápàt̪ɛ̀	ŋ ɑ p ɑ t ɛ
ɲàŋìðú	ɲ ɑ ŋ i ð ʉ
ɲàŋà	ɲ ɑ ŋ ɑ
kə́r̀lɛ̀ɲíŋí	k ə ɹ l ɛ ɲ i ŋ i
ɲájìðì	ɲ ɑ j i ð i
cát̪á	tʃ ɑ t ɑ
r̀lɛ̀ɲì	ɹ l ɛ ɲ i
t̪ə́r̀lɛ̀ɲí	t ə ɹ l ɛ ɲ i
t̪ùrì	t ʉ ɹ i
t̪ə̀nɔ̀nìnɔ̀	t ə n ɒ n i n ɒ
kɛ̀cìðú	k ɛ tʃ i ð ʉ
ŋálóŋú	ŋ ɑ l ow ŋ ʉ
búlìjɔ̀cɔ̀	b ʉ l i j ɒ tʃ ɒ
áŋàlóŋ	ɑ ŋ ɑ l ow ŋ
rə̀bùlìjí	ɹ ə b ʉ l i j i
rə̀bùlú	ɹ ə b ʉ l ʉ
káwàt̪à	k ɑ w ɑ t ɑ
rə̀bùlìðú	ɹ ə b ʉ l i ð ʉ
ŋə́kìðɔ́	ŋ ə k i ð ɒ
áwó	ɑ w ow
ŋéìt̪ɔ́	ŋ ɛ i t ɒ
ŋə́kìðìt̪ɔ́	ŋ ə k i ð i t ɒ
ít̪ɔ̀	i t ɒ
ŋə́kìðɔ̀t̪ɔ́	ŋ ə k i ð ɒ t ɒ
kíðɛ̀t̪ɛ̀	k i ð ɛ t ɛ
àwó	ɑ w ow
kíðɔ̀t̪ɔ̀	k i ð ɒ t ɒ
kìðɔ̀t̪ɔ́	k i ð ɒ t ɒ
kə̀t̪ɔ́	k ə t ɒ
kə̀t̪ìðú	k ə t i ð ʉ
t̪íðì	t i ð i
t̪íðɔ̀	t i ð ɒ
ðə́cùlɔ̀	ð ə tʃ ʉ l ɒ
jə̀ŋàcìnɔ́	j ə ŋ ɑ tʃ i n ɒ
t̪ìðú	t i ð ʉ
kə̀vɔ̀ðɔ̀t̪ɔ́	k ə v ɒ ð ɒ t ɒ
nàɾɔ́	n ɑ ɾ ɒ
nə̀ɟìrðɔ̀	n ə dʒ i ɹ ð ɒ
nìbìðú	n i b i ð ʉ
nə̀pɔ́l	n ə p ɒ l
kàɾìðó	k ɑ ɾ i ð ow
álàló	ɑ l ɑ l ow
ðìðó	ð i ð ow
ŋə́kɔ̀t̪ɔ́	ŋ ə k ɒ t ɒ
jɔ́ɾɔ́	j ɒ ɾ ɒ
ŋə́kɔ̀t̪ìjí	ŋ ə k ɒ t i j i
jɔ́ɾɔ̀	j ɒ ɾ ɒ
kɔ́t̪ìjɔ̀	k ɒ t i j ɒ
kə̀ðàt̪ɔ́	k ə ð ɑ t ɒ
ðát̪ɛ̀	ð ɑ t ɛ
ðát̪à	ð ɑ t ɑ
ðàt̪ɔ́	ð ɑ t ɒ
kə̀ðìðó	k ə ð i ð ow
jə̀ðɔ́l	j ə ð ɒ l
rə̀ðɔ́	ɹ ə ð ɒ
kɔ́t̪ɔ̀t̪ɔ́	k ɒ t ɒ t ɒ
jápìnɔ̀	j ɑ p i n ɒ
ŋə́kàɾìjí	ŋ ə k ɑ ɾ i j i
káɾìjì	k ɑ ɾ i j i
kə̀t̪ìt̪ɔ́	k ə t i t ɒ
ǹdìjí	n d i j i
jɛ́kàɾcìnɔ́	j ɛ k ɑ ɾ tʃ i n ɒ
káɾcìnɛ̀	k ɑ ɾ tʃ i n ɛ
káɾcìnɔ̀	k ɑ ɾ tʃ i n ɒ
kàɾcìnɔ́	k ɑ ɾ tʃ i n ɒ
kájú	k ɑ j ʉ
kàɾìjí	k ɑ ɾ i j i
kèɲàt̪ɔ́	k ɛ ɲ ɑ t ɒ
kàtɛ́	k ɑ t ɛ
kéɲàt̪à	k ɛ ɲ ɑ t ɑ
ídú	i d ʉ
ńdìjɔ̀	n d i j ɒ
ðə́pínɔ́	ð ə p i n ɒ
ðùpì	ð ʉ p i
ðìcò	ð i tʃ ow
ðə́píðɔ́	ð ə p i ð ɒ
nə̀pɔ́	n ə p ɒ
lə̀pɔ́l	l ə p ɒ l
káɾìjɔ̀	k ɑ ɾ i j ɒ
ɔ̀rɜ̀lír	ɒ ɹ ɐ l i ɹ
ɛ́gǎj	ɛ ɡ ɑ j
ɔ̀ràló	ɒ ɹ ɑ l ow
ŋàɾɔ́	ŋ ɑ ɾ ɒ
ŋàcìðú	ŋ ɑ tʃ i ð ʉ
ld̪ɛ́rlɛ́j	l d ɛ ɹ l ɛ j
ld̪ɛ́rlɛ́n	l d ɛ ɹ l ɛ n
ld̪ɛ́rlɜ̀lír	l d ɛ ɹ l ɐ l i ɹ
nɔ́nìðà	n ɒ n i ð ɑ
ŋɔ́nà	ŋ ɒ n ɑ
míɲàt̪à	m i ɲ ɑ t ɑ
kámìɲìt̪ɔ́	k ɑ m i ɲ i t ɒ
lìdɜ́llɛ́	l i d ɐ l l ɛ
ɛ́làló	ɛ l ɑ l ow
ɛ́lɛ́n	ɛ l ɛ n
úɽìðìjɔ̀	ʉ ɹ i ð i j ɒ
kə̀mìɲàt̪ɔ́	k ə m i ɲ ɑ t ɒ
nǔr	n ʉ ɹ
kə̀mìɲɔ́	k ə m i ɲ ɒ
kájìnìjí	k ɑ j i n i j i
kə̀ǹdìjí	k ə n d i j i
kánt̪ìjì	k ɑ n t i j i
ńdìjì	n d i j i
kìdɔ̀t̪ɔ́	k i d ɒ t ɒ
ɛ́ràló	ɛ ɹ ɑ l ow
jàŋcìnɔ́	j ɑ ŋ tʃ i n ɒ
jáŋcìnɔ́	j ɑ ŋ tʃ i n ɒ
kàŋcìnɔ́	k ɑ ŋ tʃ i n ɒ
náɾl̀ɛ́ŋì	n ɑ ɾ l ɛ ŋ i
ŋə́r̀lɛ̀ɲí	ŋ ə ɹ l ɛ ɲ i
ìmàɽðɛ́ná	i m ɑ ɹ ð ɛ n ɑ
òlá	ow l ɑ
ŋòló	ŋ ow l ow
nòló	n ow l ow
ŋʊ́dó	ŋ ʊ d ow
ɲə́r̀à	ɲ ə ɹ ɑ
ɛ́ɲɛ̀ɲí	ɛ ɲ ɛ ɲ i
lɛ̀màðáj	l ɛ m ɑ ð ɑ j
ɾácí	ɾ ɑ tʃ i
jə̀ðɔ́ŋ	j ə ð ɒ ŋ
lə̀mànáló	l ə m ɑ n ɑ l ow
lɛ̀mànɛ́n	l ɛ m ɑ n ɛ n
jáŋà	j ɑ ŋ ɑ
èdɜ́rə́lù	ɛ d ɐ ɹ ə l ʉ
jìdáŋà	j i d ɑ ŋ ɑ
lə̀ðɔ̀ŋ	l ə ð ɒ ŋ
lə̀ðɔ̀ŋɔ̀	l ə ð ɒ ŋ ɒ
lɛ̀mɛ́	l ɛ m ɛ
ŋɛ̀mɛ́	ŋ ɛ m ɛ
lɛ̀má	l ɛ m ɑ
ŋɛ̀má	ŋ ɛ m ɑ
ŋúmɔ́n	ŋ ʉ m ɒ n
ŋúmɔ́ná	ŋ ʉ m ɒ n ɑ
lúmɔ́ná	l ʉ m ɒ n ɑ
rɛ́l	ɹ ɛ l
ðàðɛ́	ð ɑ ð ɛ
və̀lɛ̀ðàt̪ìðá	v ə l ɛ ð ɑ t i ð ɑ
àðə̀ɲɛ́nɛ́	ɑ ð ə ɲ ɛ n ɛ
ɜ̀ðú	ɐ ð ʉ
ðɛ́l	ð ɛ l
lɛláj	l ɛ l ɑ j
lɛ́ŋgɜ́líŕ	l ɛ ŋ ɡ ɐ l i ɹ
ðə́nɔ̀nà	ð ə n ɒ n ɑ
ɔ̀rɜ̀lí	ɒ ɹ ɐ l i
lɛ̀ŋgàló	l ɛ ŋ ɡ ɑ l ow
lɛ̀ŋgɜ̀lí	l ɛ ŋ ɡ ɐ l i
lɛ̀ŋgɜ̀lír	l ɛ ŋ ɡ ɐ l i ɹ
lɛlàló	l ɛ l ɑ l ow
lɛlɛ́n	l ɛ l ɛ n
nónì	n ow n i
lə́ré	l ə ɹ ɛ
ðámíɲá	ð ɑ m i ɲ ɑ
ŋáɾl̀ɛ́ŋí	ŋ ɑ ɾ l ɛ ŋ i
ŋə̀r̀lɛ̀ɲí	ŋ ə ɹ l ɛ ɲ i
ŋə́nɔ̀nà	ŋ ə n ɒ n ɑ
nɔ́dɔ́ŋ	n ɒ d ɒ ŋ
nɔ́nɔ̀t̪á	n ɒ n ɒ t ɑ
ŋə́làcà	ŋ ə l ɑ tʃ ɑ
ŋámìɲà	ŋ ɑ m i ɲ ɑ
ŋə́lɛ̀ŋcì	ŋ ə l ɛ ŋ tʃ i
ŋə́lɛ̀ŋcà	ŋ ə l ɛ ŋ tʃ ɑ
ðə́lɛ́ŋcá	ð ə l ɛ ŋ tʃ ɑ
ðə́lɛ̀ŋcà	ð ə l ɛ ŋ tʃ ɑ
ŋə́lə̀vcì	ŋ ə l ə v tʃ i
ðə́kàɾcà	ð ə k ɑ ɾ tʃ ɑ
rə̀ŋgə̀lá	ɹ ə ŋ ɡ ə l ɑ
ŋə́làcì	ŋ ə l ɑ tʃ i
ðə́lácá	ð ə l ɑ tʃ ɑ
ʊ́mí	ʊ m i
ðə́làcà	ð ə l ɑ tʃ ɑ
ŋávə̀ðàcì	ŋ ɑ v ə ð ɑ tʃ i
ŋávə̀ðàcà	ŋ ɑ v ə ð ɑ tʃ ɑ
ðávə̀ðàcà	ð ɑ v ə ð ɑ tʃ ɑ
ɛ́<CL>àló	ɛ CLɑ l ow
ðámácá	ð ɑ m ɑ tʃ ɑ
úlɔ́	ʉ l ɒ
ŋwùt̪út̪ú	ŋ w ʉ t ʉ t ʉ
ɜ́rú	ɐ ɹ ʉ
ðámìɲà	ð ɑ m i ɲ ɑ
t̪út̪ú	t ʉ t ʉ
nɔ́nɔ̀t̪à	n ɒ n ɒ t ɑ
kâ	k ɑ
ðə́lə̀vcà	ð ə l ə v tʃ ɑ
ðə́ŋácá	ð ə ŋ ɑ tʃ ɑ
ðə́ŋàcà	ð ə ŋ ɑ tʃ ɑ
ĺná	l n ɑ
ðùɽùbú	ð ʉ ɹ ʉ b ʉ
ðɔ́ɽɟɛ́cá	ð ɒ ɹ dʒ ɛ tʃ ɑ
ðɔ́ɽɟɛ̀cà	ð ɒ ɹ dʒ ɛ tʃ ɑ
ŋúɽcì	ŋ ʉ ɹ tʃ i
ðúɽcá	ð ʉ ɹ tʃ ɑ
ŋə́lə̀vcà	ŋ ə l ə v tʃ ɑ
ðə́lə́vcá	ð ə l ə v tʃ ɑ
ðúɽcà	ð ʉ ɹ tʃ ɑ
ŋájìnɔ̀	ŋ ɑ j i n ɒ
ŋə́wàjà	ŋ ə w ɑ j ɑ
ðə́wájá	ð ə w ɑ j ɑ
ðə́wàjà	ð ə w ɑ j ɑ
ŋɔ́ɽɟɛ̀cì	ŋ ɒ ɹ dʒ ɛ tʃ i
ðámàcà	ð ɑ m ɑ tʃ ɑ
lɛ́màɽðén	l ɛ m ɑ ɹ ð ɛ n
ŋ̀cɔ́lɔ̀	ŋ tʃ ɒ l ɒ
t̪éɲá	t ɛ ɲ ɑ
t̪éɲâ	t ɛ ɲ ɑ
éðɔ̀ŋɔ̀	ɛ ð ɒ ŋ ɒ
ɔ́ɽɟɛ̀cìnɔ́	ɒ ɹ dʒ ɛ tʃ i n ɒ
ŋɔ́ɽɟɛ̀cìnɔ́	ŋ ɒ ɹ dʒ ɛ tʃ i n ɒ
ðə̀mànìnɔ́	ð ə m ɑ n i n ɒ
ðáɾá	ð ɑ ɾ ɑ
ðə̀mɛ̀ðìnɔ́	ð ə m ɛ ð i n ɒ
ðàmɔ̀nɛ̀	ð ɑ m ɒ n ɛ
ðàŕ	ð ɑ ɹ
ðàmàcìnɛ̀	ð ɑ m ɑ tʃ i n ɛ
rúmɛ̀	ɹ ʉ m ɛ
ðámàcìnɔ́	ð ɑ m ɑ tʃ i n ɒ
ðə́kàɾà	ð ə k ɑ ɾ ɑ
ðə̀màt̪ìnɔ̀	ð ə m ɑ t i n ɒ
làɾɛ̀	l ɑ ɾ ɛ
mát̪ìnɔ̀	m ɑ t i n ɒ
ðɔ́ɾɔ̀	ð ɒ ɾ ɒ
rɛ́ɽí	ɹ ɛ ɹ i
ðɛ̀dú	ð ɛ d ʉ
rɛ̀dú	ɹ ɛ d ʉ
ðáŕ	ð ɑ ɹ
ɛ́ɽðìnɔ̀	ɛ ɹ ð i n ɒ
áɽì	ɑ ɹ i
ðámàcìnɔ̀	ð ɑ m ɑ tʃ i n ɒ
ðɛ́ŕ	ð ɛ ɹ
ðə́ḿá	ð ə m ɑ
jə́t̪éɲárɛ́	j ə t ɛ ɲ ɑ ɹ ɛ
ɲâ	ɲ ɑ
át̪úŋ	ɑ t ʉ ŋ
áŋá	ɑ ŋ ɑ
ðɛ̀t̪ɛ́n	ð ɛ t ɛ n
t̪éɲál	t ɛ ɲ ɑ l
və́lɛ̀ðàŕ	v ə l ɛ ð ɑ ɹ
t̪ə̀t̪éɲárɛ́	t ə t ɛ ɲ ɑ ɹ ɛ
ŋɔ́ɽɟɛ̀cìnɔ̀	ŋ ɒ ɹ dʒ ɛ tʃ i n ɒ
ðɛ̀t̪áj	ð ɛ t ɑ j
ðɛ̀t̪àló	ð ɛ t ɑ l ow
ɔ́ŋɔ̀ŋɔ̀nɔ̀	ɒ ŋ ɒ ŋ ɒ n ɒ
áŋàŋìnɔ́	ɑ ŋ ɑ ŋ i n ɒ
ɔ́ŋɔ̀ŋɔ̀nɔ́	ɒ ŋ ɒ ŋ ɒ n ɒ
ŋícə̀lò	ŋ i tʃ ə l ow
ŋɔ̀nà	ŋ ɒ n ɑ
ɛ̀ðɛ̀ŋgɜ̀lír	ɛ ð ɛ ŋ ɡ ɐ l i ɹ
və́lɛ̀ðɔ́ŕ	v ə l ɛ ð ɒ ɹ
ŋə̀nɔ̀nìt̪ɔ̀t̪ɔ́	ŋ ə n ɒ n i t ɒ t ɒ
ðâ	ð ɑ
t̪ít̪éɲárɛ́	t i t ɛ ɲ ɑ ɹ ɛ
ɲə́və̀lɛ̀ðɛ̀	ɲ ə v ə l ɛ ð ɛ
ɲə́və̀lɛ̀ðà	ɲ ə v ə l ɛ ð ɑ
ŋìbíŋì	ŋ i b i ŋ i
ávt̪ɛ̀	ɑ v t ɛ
ðɛ̀t̪ɜ̀lí	ð ɛ t ɐ l i
ðɛ̀t̪ɜ̀lír	ð ɛ t ɐ l i ɹ
ɛ̀ðɛ̀ŋgɛ́j	ɛ ð ɛ ŋ ɡ ɛ j
ŋáɾl̀ɛ́ŋì	ŋ ɑ ɾ l ɛ ŋ i
káɾlɔ́ŋú	k ɑ ɾ l ɒ ŋ ʉ
nìlɛ́ð	n i l ɛ ð
káŋìnɔ́	k ɑ ŋ i n ɒ
káɾl̀ɛ́ŋì	k ɑ ɾ l ɛ ŋ i
t̪ə́ǹdì	t ə n d i
lʊ̀dó	l ʊ d ow
kírcə̀cí	k i ɹ tʃ ə tʃ i
t̪áŋú	t ɑ ŋ ʉ
ŋútìðì	ŋ ʉ t i ð i
ŋə̀ɲɛ̀làcí	ŋ ə ɲ ɛ l ɑ tʃ i
ŋə̀ɲɛ̀làcà	ŋ ə ɲ ɛ l ɑ tʃ ɑ
ŋə̀ɟìðì	ŋ ə dʒ i ð i
ðə́ɲɛ́lácá	ð ə ɲ ɛ l ɑ tʃ ɑ
ŋə̀ɾàcì	ŋ ə ɾ ɑ tʃ i
ŋə̀ɾàcà	ŋ ə ɾ ɑ tʃ ɑ
ðə́ɾácá	ð ə ɾ ɑ tʃ ɑ
ðə́ɾàcà	ð ə ɾ ɑ tʃ ɑ
ŋɜ́dì	ŋ ɐ d i
ɛ̀ðɛ̀ŋgɜ̀lí	ɛ ð ɛ ŋ ɡ ɐ l i
ŋɔ́dɔ̀	ŋ ɒ d ɒ
ðɔ́dɔ́	ð ɒ d ɒ
ðídɔ̀	ð i d ɒ
ŋíbì	ŋ i b i
ŋíbɔ̀	ŋ i b ɒ
ðíbɔ́	ð i b ɒ
émàɽðɛ́n	ɛ m ɑ ɹ ð ɛ n
ðíbɔ̀	ð i b ɒ
lɛ̀màɽðɛ́ná	l ɛ m ɑ ɹ ð ɛ n ɑ
ðɔ́ŋɔ́ŋɔ́níjɔ́	ð ɒ ŋ ɒ ŋ ɒ n i j ɒ
ŋáwà	ŋ ɑ w ɑ
ðáwà	ð ɑ w ɑ
ðíbíl	ð i b i l
ðáɽá	ð ɑ ɹ ɑ
ðə́r̀lɛ̀ɲì	ð ə ɹ l ɛ ɲ i
ŋúdì	ŋ ʉ d i
ŋúdɔ̀	ŋ ʉ d ɒ
ŋə̀ɟìðɔ̀	ŋ ə dʒ i ð ɒ
ðə́ɟíðɔ́	ð ə dʒ i ð ɒ
ŋɔ́ŋɔ̀ŋɔ̀nìjì	ŋ ɒ ŋ ɒ ŋ ɒ n i j i
kɔ́ŋɔ̀ŋɔ̀nɛ̀t̪ɛ̀	k ɒ ŋ ɒ ŋ ɒ n ɛ t ɛ
ŋɔ́ŋɔ̀ŋɔ̀nìjɔ̀	ŋ ɒ ŋ ɒ ŋ ɒ n i j ɒ
ŋúɽìðìðì	ŋ ʉ ɹ i ð i ð i
ŋúɽìðìðɔ̀	ŋ ʉ ɹ i ð i ð ɒ
ðúɽíðíðɔ́	ð ʉ ɹ i ð i ð ɒ
ðúɽìðìðɔ̀	ð ʉ ɹ i ð i ð ɒ
ðáŋìŋnìjú	ð ɑ ŋ i ŋ n i j ʉ
ðɔ́ŋɔ̀ŋɔ̀nìjɔ̀	ð ɒ ŋ ɒ ŋ ɒ n i j ɒ
ðútíðɔ́	ð ʉ t i ð ɒ
ðútìðɔ̀	ð ʉ t i ð ɒ
ŋə̀vɜ̀ɽì	ŋ ə v ɐ ɹ i
ŋə̀vɔ̀ɽɔ̀	ŋ ə v ɒ ɹ ɒ
ðúdɔ́	ð ʉ d ɒ
lìbátɛ́ŕ	l i b ɑ t ɛ ɹ
ìbɛ́j	i b ɛ j
lə̀bɛ́j	l ə b ɛ j
lə̀bɛ́n	l ə b ɛ n
wàáj	w ɑ ɑ j
wááj	w ɑ ɑ j
ðə́vɜ̀ɽì	ð ə v ɐ ɹ i
ŋə̀və̀lɛ̀cì	ŋ ə v ə l ɛ tʃ i
kə́rùŋìnɛ̀t̪ɛ̀	k ə ɹ ʉ ŋ i n ɛ t ɛ
ŋə̀və̀lɔ̀cɔ̀	ŋ ə v ə l ɒ tʃ ɒ
ðə́və́lɔ́cɔ́	ð ə v ə l ɒ tʃ ɒ
ðə́və̀lɔ̀cɔ̀	ð ə v ə l ɒ tʃ ɒ
ŋírcə̀cì	ŋ i ɹ tʃ ə tʃ i
lə̀bàlɛ́n	l ə b ɑ l ɛ n
ðírcə̀cɔ̀	ð i ɹ tʃ ə tʃ ɒ
ŋábr̀ì	ŋ ɑ b ɹ i
ŋábr̀à	ŋ ɑ b ɹ ɑ
ðábr̀à	ð ɑ b ɹ ɑ
ŋáɽì	ŋ ɑ ɹ i
ðáɽà	ð ɑ ɹ ɑ
ŋɛ́ɽðì	ŋ ɛ ɹ ð i
ŋɛ́ɽðà	ŋ ɛ ɹ ð ɑ
ðɛ́ɽðá	ð ɛ ɹ ð ɑ
ðɛ́ɽðà	ð ɛ ɹ ð ɑ
ŋáwì	ŋ ɑ w i
ŋírcə̀cɔ̀	ŋ i ɹ tʃ ə tʃ ɒ
lɔ̀ràláj	l ɒ ɹ ɑ l ɑ j
lɔ̀ràlàló	l ɒ ɹ ɑ l ɑ l ow
làɾl̀áló	l ɑ ɾ l ɑ l ow
ùnàló	ʉ n ɑ l ow
ðə́túðá	ð ə t ʉ ð ɑ
kârɔ̀	k ɑ ɹ ɒ
kɔ̀ðɔ́	k ɒ ð ɒ
ɛ́rɔ̌	ɛ ɹ ɒ
ðíðà	ð i ð ɑ
ðút̪à	ð ʉ t ɑ
lə̀bàlɛ́j	l ə b ɑ l ɛ j
lə̀bàló	l ə b ɑ l ow
ðúɽìðà	ð ʉ ɹ i ð ɑ
kɔ̀cɔ́	k ɒ tʃ ɒ
lajláj	l ɑ j l ɑ j
lajlàló	l ɑ j l ɑ l ow
t̪àló	t ɑ l ow
ɛ̀mànɜ̀lí	ɛ m ɑ n ɐ l i
ɛ̀mànɜ̀lír	ɛ m ɑ n ɐ l i ɹ
ɛ̀rə̀mt̪ɛ́j	ɛ ɹ ə m t ɛ j
ɛ̀rə̀mt̪àló	ɛ ɹ ə m t ɑ l ow
ɛ̀rə̀mt̪ɛ́n	ɛ ɹ ə m t ɛ n
ùnɛ́j	ʉ n ɛ j
ùnɛ́n	ʉ n ɛ n
ùnɜ̀lí	ʉ n ɐ l i
rə̀mt̪	ɹ ə m t
ðɛ́ŋɛ́n	ð ɛ ŋ ɛ n
ðɛ́ŋɛ́ná	ð ɛ ŋ ɛ n ɑ
r̀ðɛ̀	ɹ ð ɛ
lóðà	l ow ð ɑ
ŋíjà	ŋ i j ɑ
ŋìjà	ŋ i j ɑ
lʊ́mbɛ́	l ʊ m b ɛ
ɲávə̀lɛ̀ðɔ́	ɲ ɑ v ə l ɛ ð ɒ
ðə́kɔ́cɔ́	ð ə k ɒ tʃ ɒ
ŋìɾcɔ̀cɔ̀	ŋ i ɾ tʃ ɒ tʃ ɒ
lùɽɟénɛ́	l ʉ ɹ dʒ ɛ n ɛ
lácàcí	l ɑ tʃ ɑ tʃ i
ŋùðɛ́ɾɛ́	ŋ ʉ ð ɛ ɾ ɛ
lɔ̀t̪á	l ɒ t ɑ
ìmbə̀ɽá	i m b ə ɹ ɑ
ìɾcɔ̀cɔ̀	i ɾ tʃ ɒ tʃ ɒ
ìbàló	i b ɑ l ow
ìbɛ́n	i b ɛ n
wàɜ̀lí	w ɑ ɐ l i
játɛ́	j ɑ t ɛ
wàɜ̀lír	w ɑ ɐ l i ɹ
ðâj	ð ɑ j
ðáðɛ́	ð ɑ ð ɛ
ɛ̀ðɛ̀ŋgɛ́n	ɛ ð ɛ ŋ ɡ ɛ n
jɛ́ɽìɲɔ́	j ɛ ɹ i ɲ ɒ
cʊ́mú	tʃ ʊ m ʉ
nd̪ɔ́bàgɛ̀	n d ɒ b ɑ ɡ ɛ
ŋə́ðɛ̀	ŋ ə ð ɛ
ŋə́ðà	ŋ ə ð ɑ
ðə́ðá	ð ə ð ɑ
ðə́ðà	ð ə ð ɑ
ŋə̀nɛ̀ðɛ̀	ŋ ə n ɛ ð ɛ
làjl̀ɜ̀lír	l ɑ j l ɐ l i ɹ
ɛ̀màðɜ̀lí	ɛ m ɑ ð ɐ l i
ɛ̀màðɜ̀lír	ɛ m ɑ ð ɐ l i ɹ
lɔ̀ràlɜ̀lí	l ɒ ɹ ɑ l ɐ l i
lɔ̀ràlɜ̀lír	l ɒ ɹ ɑ l ɐ l i ɹ
ìbɜ̀lí	i b ɐ l i
ŋáɽìðì	ŋ ɑ ɹ i ð i
ðɔ́dà	ð ɒ d ɑ
ŋáɽìðà	ŋ ɑ ɹ i ð ɑ
ŋɛ́rá	ŋ ɛ ɹ ɑ
nə̀nɔ̀nɛ̀	n ə n ɒ n ɛ
t̪ə̀r̀à	t ə ɹ ɑ
ŋə̀nɔ̀nɛ̀	ŋ ə n ɒ n ɛ
kɔ̀ɾìt̪ɔ́	k ɒ ɾ i t ɒ
bɔ̀lìt̪ɔ́	b ɒ l i t ɒ
lɛlɜ̀lí	l ɛ l ɐ l i
lɛlɜ̀lír	l ɛ l ɐ l i ɹ
jɛ́r̀nɔ́	j ɛ ɹ n ɒ
jìt̪ɔ́	j i t ɒ
ŋɛ́nà	ŋ ɛ n ɑ
ðə́nɛ̀ðà	ð ə n ɛ ð ɑ
ðə́t̪ɔ́	ð ə t ɒ
ŋàŋúŋɛ́	ŋ ɑ ŋ ʉ ŋ ɛ
ŋə̀ŋàŋà	ŋ ə ŋ ɑ ŋ ɑ
pɔ́ŕ	p ɒ ɹ
ðə́ŋàŋà	ð ə ŋ ɑ ŋ ɑ
ŋúrmùðɛ̀	ŋ ʉ ɹ m ʉ ð ɛ
ŋə̀mùt̪ìnɛ̀	ŋ ə m ʉ t i n ɛ
ŋə̀mùt̪ìnɔ̀	ŋ ə m ʉ t i n ɒ
ðúrmùðɔ̀	ð ʉ ɹ m ʉ ð ɒ
ŋə̀vr̀ðɛ̀	ŋ ə v ɹ ð ɛ
ŋə̀vr̀ðɔ̀	ŋ ə v ɹ ð ɒ
ðə́vr̀ðɔ̀	ð ə v ɹ ð ɒ
ŋə̀mùt̪ɛ̀	ŋ ə m ʉ t ɛ
ŋə̀nɛ̀ðà	ŋ ə n ɛ ð ɑ
ðə́nɛ́ðá	ð ə n ɛ ð ɑ
ðə́mùt̪ɔ̀	ð ə m ʉ t ɒ
ŋábùðà	ŋ ɑ b ʉ ð ɑ
ðábùðà	ð ɑ b ʉ ð ɑ
ŋúrmùðɔ̀	ŋ ʉ ɹ m ʉ ð ɒ
ðúrmúðɔ́	ð ʉ ɹ m ʉ ð ɒ
ðáɽíðá	ð ɑ ɹ i ð ɑ
ðáɽìðà	ð ɑ ɹ i ð ɑ
ðàbà	ð ɑ b ɑ
ŋáŋà	ŋ ɑ ŋ ɑ
ðáŋá	ð ɑ ŋ ɑ
ðábà	ð ɑ b ɑ
ðáŋà	ð ɑ ŋ ɑ
ŋùmɔ̀t̪ɔ̀	ŋ ʉ m ɒ t ɒ
ðə́mút̪ɔ́	ð ə m ʉ t ɒ
ðájà	ð ɑ j ɑ
ŋə̀kàɾì	ŋ ə k ɑ ɾ i
ŋə̀kàɾà	ŋ ə k ɑ ɾ ɑ
ðə́káɾá	ð ə k ɑ ɾ ɑ
lə́rùðɛ̀	l ə ɹ ʉ ð ɛ
ŋə́ǹdì	ŋ ə n d i
ŋúd̪ɛ̀	ŋ ʉ d ɛ
ðə́d̪ùɾɔ̀	ð ə d ʉ ɾ ɒ
ŋídì	ŋ i d i
ŋídɔ̀	ŋ i d ɒ
ðídɔ́	ð i d ɒ
ŋájì	ŋ ɑ j i
ðə́rúŋɔ́	ð ə ɹ ʉ ŋ ɒ
ðə́rùŋɔ̀	ð ə ɹ ʉ ŋ ɒ
ìjàló	i j ɑ l ow
ðíðɔ́	ð i ð ɒ
ŋùdì	ŋ ʉ d i
ŋùdɔ̀cɔ̀	ŋ ʉ d ɒ tʃ ɒ
ðə́mùt̪ìnɔ̀	ð ə m ʉ t i n ɒ
ŋɔ́ŋɔ̀ŋɔ̀nɛ̀	ŋ ɒ ŋ ɒ ŋ ɒ n ɛ
ŋɔ́ŋɔ̀ŋɔ̀nɔ̀	ŋ ɒ ŋ ɒ ŋ ɒ n ɒ
ðáŋúŋú	ð ɑ ŋ ʉ ŋ ʉ
ðíðɔ̀	ð i ð ɒ
ŋə̀kìðɔ̀	ŋ ə k i ð ɒ
nə̀rùŋì	n ə ɹ ʉ ŋ i
nə̀rùŋɔ̀	n ə ɹ ʉ ŋ ɒ
nít̪ìnɔ́	n i t i n ɒ
ámálɛ́	ɑ m ɑ l ɛ
àmál	ɑ m ɑ l
ðɔ́ŋɔ̀ŋɔ̀nɔ̀	ð ɒ ŋ ɒ ŋ ɒ n ɒ
ŋə́pɛ̀	ŋ ə p ɛ
ŋə́pɔ̀	ŋ ə p ɒ
ðə́pɔ̀	ð ə p ɒ
ðə́t̪ɔ̀	ð ə t ɒ
ŋə̀tùtɛ̀	ŋ ə t ʉ t ɛ
ŋə̀tùtɔ̀	ŋ ə t ʉ t ɒ
ðə́tútɔ́	ð ə t ʉ t ɒ
ðə́tùtɔ̀	ð ə t ʉ t ɒ
ðɔ́ŋɔ́ŋɔ́nɔ́	ð ɒ ŋ ɒ ŋ ɒ n ɒ
ðáŋìŋnú	ð ɑ ŋ i ŋ n ʉ
ŋúmɛ̀ðɛ̀	ŋ ʉ m ɛ ð ɛ
jàŋàlà	j ɑ ŋ ɑ l ɑ
ŋúmɔ̀ðɔ̀	ŋ ʉ m ɒ ð ɒ
ðúmɔ́ðɔ́	ð ʉ m ɒ ð ɒ
ðúmɔ̀ðɔ̀	ð ʉ m ɒ ð ɒ
ŋə́t̪ì	ŋ ə t i
ŋə́t̪ɔ̀	ŋ ə t ɒ
ùt̪ùlá	ʉ t ʉ l ɑ
lúɽùvɔ́	l ʉ ɹ ʉ v ɒ
ŋùɽbɔ́	ŋ ʉ ɹ b ɒ
jàbà	j ɑ b ɑ
ŋə̀vàrì	ŋ ə v ɑ ɹ i
ŋút̪úl	ŋ ʉ t ʉ l
ùt̪ùlú	ʉ t ʉ l ʉ
lùt̪ùlú	l ʉ t ʉ l ʉ
ŋə́ǹdà	ŋ ə n d ɑ
ðə́ńdá	ð ə n d ɑ
ŋə́t̪à	ŋ ə t ɑ
ðə́t̪à	ð ə t ɑ
ŋə̀vàɾà	ŋ ə v ɑ ɾ ɑ
ðə́vàɾà	ð ə v ɑ ɾ ɑ
ðìjɔ̀	ð i j ɒ
ŋə̀t̪ɔ̀ɽà	ŋ ə t ɒ ɹ ɑ
ðə́t̪ɔ́ɽá	ð ə t ɒ ɹ ɑ
ðíjɔ̀	ð i j ɒ
və́lɛ̀ðìnɔ̀	v ə l ɛ ð i n ɒ
ðə́t̪ɔ́t̪á	ð ə t ɒ t ɑ
ðə́t̪ɔ̀t̪à	ð ə t ɒ t ɑ
ŕðɛ̀	ɹ ð ɛ
ŋə̀t̪ɔ̀ɽɛ̀	ŋ ə t ɒ ɹ ɛ
óɽùwɛ́l	ow ɹ ʉ w ɛ l
ðə́t̪ɔ̀ɽà	ð ə t ɒ ɹ ɑ
ŋə́t̪ɔ̀t̪ɛ̀	ŋ ə t ɒ t ɛ
ŋə́t̪ɔ̀t̪à	ŋ ə t ɒ t ɑ
nɔ́ðɛ̀ŋìnà	n ɒ ð ɛ ŋ i n ɑ
ŋùɽbí	ŋ ʉ ɹ b i
ŋùɽví	ŋ ʉ ɹ v i
ŋánt̪ɛ̀	ŋ ɑ n t ɛ
ŋɔ́nt̪ɔ̀	ŋ ɒ n t ɒ
ðə́jɛ́ðá	ð ə j ɛ ð ɑ
ðə́jɛ̀ðà	ð ə j ɛ ð ɑ
ŋíjɛ̀	ŋ i j ɛ
ðə́ðìŋnú	ð ə ð i ŋ n ʉ
úɽùwɔ̀	ʉ ɹ ʉ w ɒ
ðə́ðáŋà	ð ə ð ɑ ŋ ɑ
ŋə̀bìɽɛ̀	ŋ ə b i ɹ ɛ
ŋɔ̀bə̀ðà	ŋ ɒ b ə ð ɑ
ðə́dɔ̀ŋðà	ð ə d ɒ ŋ ð ɑ
ðɔ́mɔ̀ŋnú	ð ɒ m ɒ ŋ n ʉ
ŋát̪ìnɛ̀	ŋ ɑ t i n ɛ
ŋə́ðìnɔ̀	ŋ ə ð i n ɒ
və̀lɛ̀ðìnɔ́	v ə l ɛ ð i n ɒ
lùt̪ùlá	l ʉ t ʉ l ɑ
ðílɔ́ðɔ́	ð i l ɒ ð ɒ
ðílɔ̀ðɔ̀	ð i l ɒ ð ɒ
ŋínd̪ɛ̀t̪ɛ̀	ŋ i n d ɛ t ɛ
ŋínd̪ɔ̀t̪ɔ̀	ŋ i n d ɒ t ɒ
ðínd̪ɔ́t̪ɔ́	ð i n d ɒ t ɒ
ðínd̪ɔ̀t̪ɔ̀	ð i n d ɒ t ɒ
ŋ́cɔ́lɔ̀	ŋ tʃ ɒ l ɒ
íbí	i b i
kə̀jɔ́	k ə j ɒ
ŋìjìðì	ŋ i j i ð i
ŋə̀jɛ̀ðà	ŋ ə j ɛ ð ɑ
ŋádɔ̀ŋɔ̀nɛ̀	ŋ ɑ d ɒ ŋ ɒ n ɛ
ŋə́dɔ̀ŋðà	ŋ ə d ɒ ŋ ð ɑ
ŋə̀vɾàðà	ŋ ə v ɾ ɑ ð ɑ
ŋə̀vɾàðɛ̀	ŋ ə v ɾ ɑ ð ɛ
ðə́vɾáðá	ð ə v ɾ ɑ ð ɑ
ðə́vɾàðà	ð ə v ɾ ɑ ð ɑ
ðə́lɔ́ɽá	ð ə l ɒ ɹ ɑ
lə̀vàrɛ́ló	l ə v ɑ ɹ ɛ l ow
kɛ́cí	k ɛ tʃ i
t̪ɔ́wə̀nìdìbɔ́ðɔ̀	t ɒ w ə n i d i b ɒ ð ɒ
ŋə̀kɔ̀t̪ɛ̀	ŋ ə k ɒ t ɛ
ŋə̀mìɲɛ̀	ŋ ə m i ɲ ɛ
ŋə̀lèŋt̪ɛ̀	ŋ ə l ɛ ŋ t ɛ
ŋə̀lèŋt̪à	ŋ ə l ɛ ŋ t ɑ
ðə́léŋt̪á	ð ə l ɛ ŋ t ɑ
álú	ɑ l ʉ
ðə́lèŋt̪à	ð ə l ɛ ŋ t ɑ
ŋə̀lɔ̀ɽɛ̀	ŋ ə l ɒ ɹ ɛ
ŋə̀lɔ̀ɽà	ŋ ə l ɒ ɹ ɑ
ŋílɔ̀ðɔ̀	ŋ i l ɒ ð ɒ
ðə́lɔ̀ɽà	ð ə l ɒ ɹ ɑ
ŋə̀mɛ̀ðɛ̀	ŋ ə m ɛ ð ɛ
ŋə̀mɛ̀ðà	ŋ ə m ɛ ð ɑ
ðə́mɛ́ðá	ð ə m ɛ ð ɑ
ðə́mɛ̀ðà	ð ə m ɛ ð ɑ
mɛ́ðìnɛ̀	m ɛ ð i n ɛ
ŋə̀mɛ̀ðìnɛ̀	ŋ ə m ɛ ð i n ɛ
və́lɛ̀ðìnɛ̀	v ə l ɛ ð i n ɛ
ðə́bíɽɔ́	ð ə b i ɹ ɒ
ðə́bìɽɔ̀	ð ə b i ɹ ɒ
ŋícò	ŋ i tʃ ow
ŋílɛ̀ðɛ̀	ŋ i l ɛ ð ɛ
ðə́kɔ́t̪á	ð ə k ɒ t ɑ
ðə́kɔ̀t̪à	ð ə k ɒ t ɑ
kə̀ɲɛ̀làcíŋì	k ə ɲ ɛ l ɑ tʃ i ŋ i
kə̀ɲɛ̀làcáŋà	k ə ɲ ɛ l ɑ tʃ ɑ ŋ ɑ
kə̀və̀lɛ̀ðɔ́ŋ	k ə v ə l ɛ ð ɒ ŋ
ŋə́kɔ̀t̪à	ŋ ə k ɒ t ɑ
kə̀və̀lɛ̀ðɔ́lɔ́ŋú	k ə v ə l ɛ ð ɒ l ɒ ŋ ʉ
kə́lə̀ŋɔ́	k ə l ə ŋ ɒ
kìbìnáŋà	k i b i n ɑ ŋ ɑ
ŕná	ɹ n ɑ
káɾl̀ɛ́ŋí	k ɑ ɾ l ɛ ŋ i
ŋìðìnɔ̀	ŋ i ð i n ɒ
ánɔ̀nɔ́	ɑ n ɒ n ɒ
jɛ́r̀lɛ̀ɲí	j ɛ ɹ l ɛ ɲ i
jə́və̀lɛ̀ðɔ́	j ə v ə l ɛ ð ɒ
nɔ́dɛ̀	n ɒ d ɛ
ŋìðɛ́ŋí	ŋ i ð ɛ ŋ i
ŋúmɛ̀	ŋ ʉ m ɛ
ŋə́mà	ŋ ə m ɑ
ðə́m̀à	ð ə m ɑ
ðə́ŋárðá	ð ə ŋ ɑ ɹ ð ɑ
ðə́ŋàrðà	ð ə ŋ ɑ ɹ ð ɑ
ɛ̀lə̀ŋà	ɛ l ə ŋ ɑ
ŋə̀mìɲà	ŋ ə m i ɲ ɑ
ŋə́ná	ŋ ə n ɑ
ðɛ́nà	ð ɛ n ɑ
ɛ́lə̀ŋà	ɛ l ə ŋ ɑ
ðə̀làŋà	ð ə l ɑ ŋ ɑ
núnɛ́	n ʉ n ɛ
ŋə̀nɔ̀nà	ŋ ə n ɒ n ɑ
ðə́nɔ́ná	ð ə n ɒ n ɑ
ŋɔ́dɛ̀	ŋ ɒ d ɛ
ɛ̀ŋná	ɛ ŋ n ɑ
ŋɔ́dà	ŋ ɒ d ɑ
ðɔ́dá	ð ɒ d ɑ
ŋə̀ná	ŋ ə n ɑ
ŋ́ná	ŋ n ɑ
ðɔ́ɽá	ð ɒ ɹ ɑ
ðɔ́ɽà	ð ɒ ɹ ɑ
ðáɽə́ŋát̪á	ð ɑ ɹ ə ŋ ɑ t ɑ
ŋə́r̀dà	ŋ ə ɹ d ɑ
ðɛ́rdá	ð ɛ ɹ d ɑ
ŋə̀ɾ̀làndɛ̀	ŋ ə ɾ l ɑ n d ɛ
ŋə̀ɾ̀làndà	ŋ ə ɾ l ɑ n d ɑ
ðə́ɾ́lándá	ð ə ɾ l ɑ n d ɑ
ðə́ɾ̀làndà	ð ə ɾ l ɑ n d ɑ
ŋɔ́rà	ŋ ɒ ɹ ɑ
ðə́r̀à	ð ə ɹ ɑ
ŋə́r̀dɛ̀	ŋ ə ɹ d ɛ
íɾìcɔ̀cɔ̀	i ɾ i tʃ ɒ tʃ ɒ
ŋə́r̀ɛ̀	ŋ ə ɹ ɛ
ŋə̀bùrŋ̀à	ŋ ə b ʉ ɹ ŋ ɑ
ŋə̀bùrŋ̀ɛ̀	ŋ ə b ʉ ɹ ŋ ɛ
kə̀ɲɛ̀làcátɛ́	k ə ɲ ɛ l ɑ tʃ ɑ t ɛ
kə̀ɲɛ̀làcátɛ́ŕ	k ə ɲ ɛ l ɑ tʃ ɑ t ɛ ɹ
kɛ̀cìŋgàlàlátɛ́r	k ɛ tʃ i ŋ ɡ ɑ l ɑ l ɑ t ɛ ɹ
ŋábr̀t̪ɛ̀	ŋ ɑ b ɹ t ɛ
ŋábr̀t̪à	ŋ ɑ b ɹ t ɑ
ðábr̀t̪à	ð ɑ b ɹ t ɑ
ŋábòt̪ɛ̀	ŋ ɑ b ow t ɛ
ŋábòt̪à	ŋ ɑ b ow t ɑ
ðábót̪á	ð ɑ b ow t ɑ
ŋáɽə̀ŋàt̪ɛ̀	ŋ ɑ ɹ ə ŋ ɑ t ɛ
ðáɽə̀ŋàt̪à	ð ɑ ɹ ə ŋ ɑ t ɑ
ŋálèŋɛ̀	ŋ ɑ l ɛ ŋ ɛ
ŋálèŋà	ŋ ɑ l ɛ ŋ ɑ
ðálèŋà	ð ɑ l ɛ ŋ ɑ
ŋápɛ̀	ŋ ɑ p ɛ
ðábŕt̪á	ð ɑ b ɹ t ɑ
àbr̀ó	ɑ b ɹ ow
líɾcɔ̀cɔ̀	l i ɾ tʃ ɒ tʃ ɒ
ŋárðìnɛ̀	ŋ ɑ ɹ ð i n ɛ
ðáɾðá	ð ɑ ɾ ð ɑ
ðáɾðà	ð ɑ ɾ ð ɑ
ŋápà	ŋ ɑ p ɑ
ðápá	ð ɑ p ɑ
ðə́lɔ̀ɽìŋjú	ð ə l ɒ ɹ i ŋ j ʉ
ðíɲínɔ́	ð i ɲ i n ɒ
ðə́lɔ̀ɽɔ́ŋ	ð ə l ɒ ɹ ɒ ŋ
ðə́búrŋ́á	ð ə b ʉ ɹ ŋ ɑ
ŋə̀dɔ̀ŋðɛ̀	ŋ ə d ɒ ŋ ð ɛ
ŋə̀dɔ̀ŋðà	ŋ ə d ɒ ŋ ð ɑ
ŋə̀ɽìɲɛ̀	ŋ ə ɹ i ɲ ɛ
ŋə̀ɽìɲà	ŋ ə ɹ i ɲ ɑ
kə̀ɲɛ̀làcɜ́llíŕ	k ə ɲ ɛ l ɑ tʃ ɐ l l i ɹ
kə̀ɲɛ̀làcáɲà	k ə ɲ ɛ l ɑ tʃ ɑ ɲ ɑ
ŋə́kèɲɛ̀	ŋ ə k ɛ ɲ ɛ
ðə́kéɲá	ð ə k ɛ ɲ ɑ
ðə́kèɲà	ð ə k ɛ ɲ ɑ
ðə́bùrŋ̀à	ð ə b ʉ ɹ ŋ ɑ
lìɾcɔ̀cɔ̀	l i ɾ tʃ ɒ tʃ ɒ
ðə́ɽíɲá	ð ə ɹ i ɲ ɑ
ðə́ɽìɲà	ð ə ɹ i ɲ ɑ
ɔ̀ɽɟɛ̀cí	ɒ ɹ dʒ ɛ tʃ i
ŋgɛ́gɛ́	ŋ ɡ ɛ ɡ ɛ
kə̀ɲɛ̀làcíŋí	k ə ɲ ɛ l ɑ tʃ i ŋ i
kə̀ɲɛ̀làcáŋá	k ə ɲ ɛ l ɑ tʃ ɑ ŋ ɑ
kə̀ɲɛ̀làcáló	k ə ɲ ɛ l ɑ tʃ ɑ l ow
kə̀ɲɛ̀làcáɲá	k ə ɲ ɛ l ɑ tʃ ɑ ɲ ɑ
kə̀ɲɛ̀làcíl	k ə ɲ ɛ l ɑ tʃ i l
t̪ə̀və̀lɛ̀ðɛ́ŋì	t ə v ə l ɛ ð ɛ ŋ i
kə̀ɲɛ̀làcéɲárɛ́	k ə ɲ ɛ l ɑ tʃ ɛ ɲ ɑ ɹ ɛ
kə̀ɲɛ̀làcíŋ	k ə ɲ ɛ l ɑ tʃ i ŋ
lə̀ɲɛ̀làcílɔ́ŋú	l ə ɲ ɛ l ɑ tʃ i l ɒ ŋ ʉ
kàŋâ	k ɑ ŋ ɑ
kɛ̀	k ɛ
kàŋì	k ɑ ŋ i
kɔ̀ɽɟɛ̀cáŋá	k ɒ ɹ dʒ ɛ tʃ ɑ ŋ ɑ
kɔ̀ɽɟɛ̀cáŋágɛ́	k ɒ ɹ dʒ ɛ tʃ ɑ ŋ ɑ ɡ ɛ
rə́və̀lɛ̀ðáɲárɛ́	ɹ ə v ə l ɛ ð ɑ ɲ ɑ ɹ ɛ
kɔ́ɽɟɛ̀cí	k ɒ ɹ dʒ ɛ tʃ i
t̪ɔ́ɽɟɛ̀cíŋì	t ɒ ɹ dʒ ɛ tʃ i ŋ i
ðùɽá	ð ʉ ɹ ɑ
kə̀nɛ̀ðéɲárɛ́	k ə n ɛ ð ɛ ɲ ɑ ɹ ɛ
rɔ́mɔ̂	ɹ ɒ m ɒ
jɔ́ɽɟɛ̀cáŋà	j ɒ ɹ dʒ ɛ tʃ ɑ ŋ ɑ
kə̀və̀lɛ̀ðlɔ́ŋú	k ə v ə l ɛ ð l ɒ ŋ ʉ
kɛ̀ɾɔ́	k ɛ ɾ ɒ
léɲá	l ɛ ɲ ɑ
kàl	k ɑ l
t̪ə̀mɛ̀rðɔ́	t ə m ɛ ɹ ð ɒ
mɛ̀rðɔ́	m ɛ ɹ ð ɒ
rə̀jɛ̀ðéɲárɛ́	ɹ ə j ɛ ð ɛ ɲ ɑ ɹ ɛ
kàŋà	k ɑ ŋ ɑ
və̀lɛ̀ðìnɔ́ŕ	v ə l ɛ ð i n ɒ ɹ
jìdìjí	j i d i j i
ðícíŋgɛ́lálá	ð i tʃ i ŋ ɡ ɛ l ɑ l ɑ
ðícìŋgɛ̀làlà	ð i tʃ i ŋ ɡ ɛ l ɑ l ɑ
kə̀mɛ̀ðátɛ́ŕ	k ə m ɛ ð ɑ t ɛ ɹ
lə́ðátɛ́ŕ	l ə ð ɑ t ɛ ɹ
və́lɛ́ðínɔ́	v ə l ɛ ð i n ɒ
íŋgáĺl	i ŋ ɡ ɑ l l
lɛ̀cìŋgɛ̀làlí	l ɛ tʃ i ŋ ɡ ɛ l ɑ l i
làcíŋgɛ̀làlì	l ɑ tʃ i ŋ ɡ ɛ l ɑ l i
lácíŋgɛ̀làlà	l ɑ tʃ i ŋ ɡ ɛ l ɑ l ɑ
lácìŋgɛ̀làlí	l ɑ tʃ i ŋ ɡ ɛ l ɑ l i
ŋùdíŋɛ́	ŋ ʉ d i ŋ ɛ
ŋút̪ìnɔ̀	ŋ ʉ t i n ɒ
ŋə́ŋt̪ɔ̀t̪ú	ŋ ə ŋ t ɒ t ʉ
nâl	n ɑ l
mút̪ɔ̀t̪ɔ̀	m ʉ t ɒ t ɒ
ùdúlə́ŋàɲà	ʉ d ʉ l ə ŋ ɑ ɲ ɑ
láŋáɲà	l ɑ ŋ ɑ ɲ ɑ
lə́lə̀ŋáɲà	l ə l ə ŋ ɑ ɲ ɑ
àŋú	ɑ ŋ ʉ
ŋùd̪ɔ̀t̪áɲà	ŋ ʉ d ɒ t ɑ ɲ ɑ
ndŕdɔ́	n d ɹ d ɒ
ŋɔ́rɔ́	ŋ ɒ ɹ ɒ
nɜ́rʊ́	n ɐ ɹ ʊ
jɔ̀ndɔ̀	j ɒ n d ɒ
nàlbríð	n ɑ l b ɹ i ð
ámɔ̀nɛ̀	ɑ m ɒ n ɛ
ámɛ̀rðɔ́	ɑ m ɛ ɹ ð ɒ
mɛ́rðà	m ɛ ɹ ð ɑ
nɔ̀ðɛ̀ŋìnà	n ɒ ð ɛ ŋ i n ɑ
ŋɔ́mɛ́	ŋ ɒ m ɛ
ŋə̀vàvɾì	ŋ ə v ɑ v ɾ i
lúrɔ̀	l ʉ ɹ ɒ
ìɾdɛ̀cí	i ɾ d ɛ tʃ i
ŋíɾdɛ̀cì	ŋ i ɾ d ɛ tʃ i
jɜ́ŋdɛ̀cú	j ɐ ŋ d ɛ tʃ ʉ
kə́r̀nà	k ə ɹ n ɑ
ŋárdɛ̀cɔ̀t̪ɔ̀lɲánú	ŋ ɑ ɹ d ɛ tʃ ɒ t ɒ l ɲ ɑ n ʉ
ɟígrə̀mnǎ	dʒ i ɡ ɹ ə m n ɑ
ìrdɔ̀dɔ̀t̪ɔ́	i ɹ d ɒ d ɒ t ɒ
jálèŋɔ́	j ɑ l ɛ ŋ ɒ
ímàɽðɛ́ná	i m ɑ ɹ ð ɛ n ɑ
kìbáɲà	k i b ɑ ɲ ɑ
kə̀lə̀ŋɔ́	k ə l ə ŋ ɒ
ɔ́dɔ̀ŕ	ɒ d ɒ ɹ
ɔ́dɔ́ŕ	ɒ d ɒ ɹ
lə́vɜ̀ɽì	l ə v ɐ ɹ i
ŋíðìŋjú	ŋ i ð i ŋ j ʉ
ŋə́r̀ɛ́ŋí	ŋ ə ɹ ɛ ŋ i
kíbíŋú	k i b i ŋ ʉ
nàl	n ɑ l
lə̀cə̀là	l ə tʃ ə l ɑ
lírcɛ̀cɔ̀	l i ɹ tʃ ɛ tʃ ɒ
íɾdɛ̀cì	i ɾ d ɛ tʃ i
kɜ́ní	k ɐ n i
jɔ́ðìnɔ́	j ɒ ð i n ɒ
ŋàcìjí	ŋ ɑ tʃ i j i
t̪ə̀ŋàcíl	t ə ŋ ɑ tʃ i l
ŋə́ŋàŋáɲà	ŋ ə ŋ ɑ ŋ ɑ ɲ ɑ
ŋáŋáɲà	ŋ ɑ ŋ ɑ ɲ ɑ
ŋùdóɾŋɛ́ŋầɲà	ŋ ʉ d ow ɾ ŋ ɛ ŋ ɑ ɲ ɑ
ŋácíjí	ŋ ɑ tʃ i j i
ŋɜ̀dɛ̀cí	ŋ ɐ d ɛ tʃ i
ŋàvə̀lɛ̀	ŋ ɑ v ə l ɛ
líbíl	l i b i l
lə́r̀dɛ̀	l ə ɹ d ɛ
ɜ́dɛ̀cì	ɐ d ɛ tʃ i
íɾɔ̀vɛ́	i ɾ ɒ v ɛ
ìɾɔ̀vɛ́	i ɾ ɒ v ɛ
ŋùd̪ɔ́ŋɛ́	ŋ ʉ d ɒ ŋ ɛ
ŋə̀ðìnɔ́	ŋ ə ð i n ɒ
ŋə̀r̀náɲà	ŋ ə ɹ n ɑ ɲ ɑ
ŋìbɛ̀cí	ŋ i b ɛ tʃ i
ŋìbɛ̀cì	ŋ i b ɛ tʃ i
ðɾɔ́v	ð ɾ ɒ v
áŋìðìnɔ́	ɑ ŋ i ð i n ɒ
rə́mànà	ɹ ə m ɑ n ɑ
ðíɲɔ́	ð i ɲ ɒ
ŋàɾìnɔ́	ŋ ɑ ɾ i n ɒ
láŋə́lvə́lɛ̂ðàló	l ɑ ŋ ə l v ə l ɛ ð ɑ l ow
ŋgáló	ŋ ɡ ɑ l ow
lə̀və̀lɛ̀ðátɛ́	l ə v ə l ɛ ð ɑ t ɛ
ávə̀lɛ̀ðìnɔ́	ɑ v ə l ɛ ð i n ɒ
jɛ́və̀lɛ̀ðìnɔ́	j ɛ v ə l ɛ ð i n ɒ
kə̀və̀lɛ̀ðìnɔ́	k ə v ə l ɛ ð i n ɒ
ɲáláŋâ	ɲ ɑ l ɑ ŋ ɑ
ŋíɾdɔ̀cɔ̀	ŋ i ɾ d ɒ tʃ ɒ
ŋácìt̪ɛ̀	ŋ ɑ tʃ i t ɛ
rə̀t̪ɔ̀	ɹ ə t ɒ
íɾdɛ̀cí	i ɾ d ɛ tʃ i
lávə̀là	l ɑ v ə l ɑ
lávt̪à	l ɑ v t ɑ
ládìjà	l ɑ d i j ɑ
ládìjɔ́	l ɑ d i j ɒ
lábràt̪ɔ́	l ɑ b ɹ ɑ t ɒ
t̪úrì	t ʉ ɹ i
ŋàmìɲí	ŋ ɑ m i ɲ i
ŋámìɲí	ŋ ɑ m i ɲ i
ŋárŋàcà	ŋ ɑ ɹ ŋ ɑ tʃ ɑ
t̪ə̀ɽìɲɔ́	t ə ɹ i ɲ ɒ
nàvt̪à	n ɑ v t ɑ
ŋúmɔ́	ŋ ʉ m ɒ
ŋɜ́dɛ̀cí	ŋ ɐ d ɛ tʃ i
káǹíŋâiɲɔ́	k ɑ n i ŋ ɑ i ɲ ɒ
ŋámíɲ́ɛŋnɔ̀rnɔ̀	ŋ ɑ m i ɲ ɛ ŋ n ɒ ɹ n ɒ
ŋàðrɛ̀ḿnɔ́mnà	ŋ ɑ ð ɹ ɛ m n ɒ m n ɑ
ðáĺ	ð ɑ l
nə̀r̀nà	n ə ɹ n ɑ
kɔ́nt̪ɔ̀	k ɒ n t ɒ
dɔ́ŋðɔ̀t̪à	d ɒ ŋ ð ɒ t ɑ
áɽà	ɑ ɹ ɑ
láɾl̀ɔ́	l ɑ ɾ l ɒ
lə́vàrú	l ə v ɑ ɹ ʉ
lábrìðà	l ɑ b ɹ i ð ɑ
lábràt̪à	l ɑ b ɹ ɑ t ɑ
lə̀və̀lɛ̀ðìnɔ́	l ə v ə l ɛ ð i n ɒ
kə̀və̀lɛ̀ðáɲá	k ə v ə l ɛ ð ɑ ɲ ɑ
lə̀və̀lɛ̀ðɛ́ŋì	l ə v ə l ɛ ð ɛ ŋ i
kə̀və̀lɛ̀ðátɛ́	k ə v ə l ɛ ð ɑ t ɛ
kə̀və̀lɛ̀ðátɛ́ŕ	k ə v ə l ɛ ð ɑ t ɛ ɹ
làɾàt̪ɔ́	l ɑ ɾ ɑ t ɒ
láɾìðó	l ɑ ɾ i ð ow
kə̀və̀lɛ̀ðɜ́llíŕ	k ə v ə l ɛ ð ɐ l l i ɹ
kə̀və̀lɛ̀ðɜ́l	k ə v ə l ɛ ð ɐ l
ɲə́və̀lɛ̀ðɛ́ŋì	ɲ ə v ə l ɛ ð ɛ ŋ i
rɔ́ðà	ɹ ɒ ð ɑ
ráɽà	ɹ ɑ ɹ ɑ
lídú	l i d ʉ
láɽàt̪ìðà	l ɑ ɹ ɑ t i ð ɑ
lɔ́ɽɔ̀t̪ìðó	l ɒ ɹ ɒ t i ð ow
r̀nɔ́	ɹ n ɒ
lə́ɽòt̪à	l ə ɹ ow t ɑ
láɾt̪ìŋnú	l ɑ ɾ t i ŋ n ʉ
ít̪ɔ̀t̪ɔ̀	i t ɒ t ɒ
kávə̀làt̪à	k ɑ v ə l ɑ t ɑ
kàblàt̪ó	k ɑ b l ɑ t ow
ŋàlàt̪ɔ́	ŋ ɑ l ɑ t ɒ
rùðɔ́	ɹ ʉ ð ɒ
làbrìðó	l ɑ b ɹ i ð ow
ðàŋìnɔ̀	ð ɑ ŋ i n ɒ
kɔ́ðáŋà	k ɒ ð ɑ ŋ ɑ
ŋɔ̀n	ŋ ɒ n
lə̀və̀lɛ̀ðéɲárɛ́	l ə v ə l ɛ ð ɛ ɲ ɑ ɹ ɛ
lə̀və̀lɛ̀ðáŋà	l ə v ə l ɛ ð ɑ ŋ ɑ
láŋâl	l ɑ ŋ ɑ l
ŋálà	ŋ ɑ l ɑ
lə̀və̀lɛ̀ðɜ́llíŕ	l ə v ə l ɛ ð ɐ l l i ɹ
lə̀və̀lɛ̀ðáɲàl	l ə v ə l ɛ ð ɑ ɲ ɑ l
ɲə̀və̀lɛ̀ðátɛ́	ɲ ə v ə l ɛ ð ɑ t ɛ
ɲə́və̀lɛ̀ðéɲárɛ́	ɲ ə v ə l ɛ ð ɛ ɲ ɑ ɹ ɛ
ùrnɛ̀ŋgɛ́j	ʉ ɹ n ɛ ŋ ɡ ɛ j
léɲâ	l ɛ ɲ ɑ
kɔ́ɽɔ̀t̪ɔ́	k ɒ ɹ ɒ t ɒ
mánú	m ɑ n ʉ
ŋáló	ŋ ɑ l ow
láŋàt̪ɔ́	l ɑ ŋ ɑ t ɒ
lɔ́bə̀ðà	l ɒ b ə ð ɑ
ɔ́bə̀ðà	ɒ b ə ð ɑ
nə́jɔ́ŋ	n ə j ɒ ŋ
kə́mùt̪ɔ́	k ə m ʉ t ɒ
kə́mùt̪ɔ̀	k ə m ʉ t ɒ
nát̪á	n ɑ t ɑ
kə̀mùt̪ɔ́	k ə m ʉ t ɒ
kə̀mùt̪ɛ̀	k ə m ʉ t ɛ
lɔ́ɽɔ̀t̪ɔ́	l ɒ ɹ ɒ t ɒ
lɔ́ɽàt̪ìðó	l ɒ ɹ ɑ t i ð ow
kùmɛ̀t̪ìnɛ́ŋì	k ʉ m ɛ t i n ɛ ŋ i
kùmɔ̀t̪ɛ́ŋí	k ʉ m ɒ t ɛ ŋ i
ŋùt̪ì	ŋ ʉ t i
kút̪ì	k ʉ t i
ŋéɲár	ŋ ɛ ɲ ɑ ɹ
áɽàŕ	ɑ ɹ ɑ ɹ
kùmɔ̀t̪ɔ́ŋ	k ʉ m ɒ t ɒ ŋ
kə̀mùt̪ɔ̀t̪áŋà	k ə m ʉ t ɒ t ɑ ŋ ɑ
náŋú	n ɑ ŋ ʉ
ńɔ́ŕ	n ɒ ɹ
núrúŋú	n ʉ ɹ ʉ ŋ ʉ
nút̪úŋú	n ʉ t ʉ ŋ ʉ
néɲár	n ɛ ɲ ɑ ɹ
kə́mùt̪ɛ̀	k ə m ʉ t ɛ
níŋjú	n i ŋ j ʉ
kə̀mùt̪ìjí	k ə m ʉ t i j i
kə̀və̀lɛ̀ðáŋà	k ə v ə l ɛ ð ɑ ŋ ɑ
ðə̀və̀lɛ̀ðɛ́ŋí	ð ə v ə l ɛ ð ɛ ŋ i
kùmɔ̀t̪ɔ́	k ʉ m ɒ t ɒ
làŋɛ̂	l ɑ ŋ ɛ
ŋùmɛ̀	ŋ ʉ m ɛ
ŋàdìjà	ŋ ɑ d i j ɑ
núrú	n ʉ ɹ ʉ
ŋárɽàt̪ɛ̀	ŋ ɑ ɹ ɹ ɑ t ɛ
kə̀və̀lɛ̀ðɛ́ŋì	k ə v ə l ɛ ð ɛ ŋ i
ŋálìŕ	ŋ ɑ l i ɹ
kàbòt̪ɔ́	k ɑ b ow t ɒ
t̪íŕ	t i ɹ
úmɛ̀	ʉ m ɛ
ŋìcò	ŋ i tʃ ow
ŋɜ̀ðɜ̀ŋìnɔ́	ŋ ɐ ð ɐ ŋ i n ɒ
ŋèðìŋnìnú	ŋ ɛ ð i ŋ n i n ʉ
nɔ̀ðáŋánɛ́	n ɒ ð ɑ ŋ ɑ n ɛ
ðáŋì	ð ɑ ŋ i
ŋɜ̀ðɜ̀ŋìnáló	ŋ ɐ ð ɐ ŋ i n ɑ l ow
ŋìbì	ŋ i b i
ŋèðìniŋ̀ðìnú	ŋ ɛ ð i n i ŋ ð i n ʉ
ŋìðìŋnú	ŋ i ð i ŋ n ʉ
ŋɜ̀ðɜ̀ŋiŋ̀nú	ŋ ɐ ð ɐ ŋ i ŋ n ʉ
ŋàlèŋìðìŋnú	ŋ ɑ l ɛ ŋ i ð i ŋ n ʉ
kɜ́dáŋà	k ɐ d ɑ ŋ ɑ
nɜ́ðɜ̀ŋìnɔ́	n ɐ ð ɐ ŋ i n ɒ
ŋɜ́ðɜ̀ŋìnɛ̀	ŋ ɐ ð ɐ ŋ i n ɛ
káɾðáŋá	k ɑ ɾ ð ɑ ŋ ɑ
áŋìðà	ɑ ŋ i ð ɑ
ŋə̀ðɛ̀	ŋ ə ð ɛ
éŋɛ̀ɾà	ɛ ŋ ɛ ɾ ɑ
ɛ́bɛ̀	ɛ b ɛ
ŋìðiŋ̀nú	ŋ i ð i ŋ n ʉ
ŋíbɔ̀cɔ̀	ŋ i b ɒ tʃ ɒ
ŋɜ́ðɜ̀ŋìnáló	ŋ ɐ ð ɐ ŋ i n ɑ l ow
ŋɛ̂l	ŋ ɛ l
kə́ðáŋá	k ə ð ɑ ŋ ɑ
ŋávt̪àt̪ɔ́	ŋ ɑ v t ɑ t ɒ
káŋìðáŋá	k ɑ ŋ i ð ɑ ŋ ɑ
ŋə́ðìnɛ̀	ŋ ə ð i n ɛ
ðə́ŋɛ̀ɾà	ð ə ŋ ɛ ɾ ɑ
ŋáɾðìnáló	ŋ ɑ ɾ ð i n ɑ l ow
út̪à	ʉ t ɑ
ùt̪ú	ʉ t ʉ
lávt̪ɔ́	l ɑ v t ɒ
lɔ́ðɔ́	l ɒ ð ɒ
píɽìnɔ̀	p i ɹ i n ɒ
íɾdɔ̀cɔ̀	i ɾ d ɒ tʃ ɒ
ŋə̀ðìŋnú	ŋ ə ð i ŋ n ʉ
námɔ̀nɛ̀t̪ìnɔ́ŋú	n ɑ m ɒ n ɛ t i n ɒ ŋ ʉ
t̪údí	t ʉ d i
ŋɜ̀ðɜ̀ŋìnɛ̀	ŋ ɐ ð ɐ ŋ i n ɛ
pìɽìnɔ́	p i ɹ i n ɒ
lárŋ̀à	l ɑ ɹ ŋ ɑ
t̪áɽáɲá	t ɑ ɹ ɑ ɲ ɑ
t̪ɔ́rnìnɔ̀	t ɒ ɹ n i n ɒ
lɔ́ðà	l ɒ ð ɑ
ðùɽó	ð ʉ ɹ ow
ɔ́ɽìnɔ̀	ɒ ɹ i n ɒ
làpìt̪ìnɔ́	l ɑ p i t i n ɒ
ðìt̪ɔ́	ð i t ɒ
lə́ɟìðìnìjì	l ə dʒ i ð i n i j i
ðàɾìt̪ɔ́	ð ɑ ɾ i t ɒ
ðàɾìt̪ɔ́l	ð ɑ ɾ i t ɒ l
ðù	ð ʉ
ìdìjí	i d i j i
jɜ̀dìjí	j ɐ d i j i
ðíjáló	ð i j ɑ l ow
ápìðìjì	ɑ p i ð i j i
lə́ɟìðìðì	l ə dʒ i ð i ð i
ǹɔ́	n ɒ
rù	ɹ ʉ
láɽáɲà	l ɑ ɹ ɑ ɲ ɑ
ɽàɲìðú	ɹ ɑ ɲ i ð ʉ
kɛ́ɾà	k ɛ ɾ ɑ
kàɾt̪ìnɔ́	k ɑ ɾ t i n ɒ
ŋɜ́dìjì	ŋ ɐ d i j i
údíŕ	ʉ d i ɹ
kə́kàɾìnɔ́	k ə k ɑ ɾ i n ɒ
ðápìjáŋà	ð ɑ p i j ɑ ŋ ɑ
ðî	ð i
àɾìt̪ɔ́	ɑ ɾ i t ɒ
út̪ú	ʉ t ʉ
káɾt̪ìnɔ̀	k ɑ ɾ t i n ɒ
t̪ɔ̀ɽáló	t ɒ ɹ ɑ l ow
kə̀bìɽɔ́gɛ́	k ə b i ɹ ɒ ɡ ɛ
lə̀bìɽáló	l ə b i ɹ ɑ l ow
kúkùŋðɔ́ndà	k ʉ k ʉ ŋ ð ɒ n d ɑ
ídíjí	i d i j i
ðɔ́ɾt̪ɔ̀	ð ɒ ɾ t ɒ
ŋɔ́ɽáló	ŋ ɒ ɹ ɑ l ow
kúkùŋɔ̀ŋŋíɲár	k ʉ k ʉ ŋ ɒ ŋ ŋ i ɲ ɑ ɹ
àɾàt̪á	ɑ ɾ ɑ t ɑ
káŋâl	k ɑ ŋ ɑ l
éd̪ɛ̀ɾɛ́	ɛ d ɛ ɾ ɛ
jáŋâ	j ɑ ŋ ɑ
ŋídìjí	ŋ i d i j i
ídìðìnɛ̀	i d i ð i n ɛ
íbíjí	i b i j i
wa	w ɑ
kùdìjì	k ʉ d i j i
làɾt̪ìŋjú	l ɑ ɾ t i ŋ j ʉ
ápàt̪à	ɑ p ɑ t ɑ
t̪íjí	t i j i
údí	ʉ d i
nɜ́dìðì	n ɐ d i ð i
káɾt̪ìnɔ́	k ɑ ɾ t i n ɒ
ŋídìjì	ŋ i d i j i
ŋídìðɔ̀	ŋ i d i ð ɒ
ðát̪ɔ́	ð ɑ t ɒ
láɾìt̪ɔ́	l ɑ ɾ i t ɒ
úɽɔ́	ʉ ɹ ɒ
kàðɛ́ŋɛ́nɛ́	k ɑ ð ɛ ŋ ɛ n ɛ
nə̀ɽà	n ə ɹ ɑ
nâj	n ɑ j
kàŋéɲárɛ́	k ɑ ŋ ɛ ɲ ɑ ɹ ɛ
lə̀d̪ɛ̀ɾɛ́	l ə d ɛ ɾ ɛ
làɾìt̪áŋá	l ɑ ɾ i t ɑ ŋ ɑ
làɾàt̪à	l ɑ ɾ ɑ t ɑ
ŋàŋéɲárɛ́	ŋ ɑ ŋ ɛ ɲ ɑ ɹ ɛ
nə̀r̀ɛ̀	n ə ɹ ɛ
kə̀mɛ̀rðɔ́	k ə m ɛ ɹ ð ɒ
áɾt̪áŋáŋ́ɲár	ɑ ɾ t ɑ ŋ ɑ ŋ ɲ ɑ ɹ
t̪átɛ́	t ɑ t ɛ
ðàɾt̪ìŋjú	ð ɑ ɾ t i ŋ j ʉ
vɛ̀ðɛ̀	v ɛ ð ɛ
láɾìt̪ɔ́l	l ɑ ɾ i t ɒ l
làɾìt̪ɔ́l	l ɑ ɾ i t ɒ l
ŋàmɔ̀rðápríɲâ	ŋ ɑ m ɒ ɹ ð ɑ p ɹ i ɲ ɑ
ðə̀mɛ̀rðɔ́	ð ə m ɛ ɹ ð ɒ
lə̀mɛ̀rðɔ́	l ə m ɛ ɹ ð ɒ
káwŋú	k ɑ w ŋ ʉ
àɾɔ́ŕ	ɑ ɾ ɒ ɹ
lə̀mɛ̀rðɔ́l	l ə m ɛ ɹ ð ɒ l
t̪ámə́rðààpríɲâ	t ɑ m ə ɹ ð ɑ ɑ p ɹ i ɲ ɑ
nə̀və̀lɛ̀ðɔ́	n ə v ə l ɛ ð ɒ
ðáŋàlàùnɛ́rɛ̂	ð ɑ ŋ ɑ l ɑ ʉ n ɛ ɹ ɛ
nɔ́ðɔ́ŋúnɛ́	n ɒ ð ɒ ŋ ʉ n ɛ
jə́ɽàɲìðú	j ə ɹ ɑ ɲ i ð ʉ
t̪ə́ɽìɲɔ́lɔ́ŋú	t ə ɹ i ɲ ɒ l ɒ ŋ ʉ
ŋɔ́ðɔ́ŋ	ŋ ɒ ð ɒ ŋ
ńá	n ɑ
t̪ə̀ɽìɲɔ́ŋú	t ə ɹ i ɲ ɒ ŋ ʉ
mɛ́rðàt̪ɔ́	m ɛ ɹ ð ɑ t ɒ
ɾ́làndàt̪ɛ̀	ɾ l ɑ n d ɑ t ɛ
lə̀cìŋgìlàlì	l ə tʃ i ŋ ɡ i l ɑ l i
mɛ́rðìðìt̪ɛ̀	m ɛ ɹ ð i ð i t ɛ
ɲàd̪ùɾɔ̀t̪ɔ́	ɲ ɑ d ʉ ɾ ɒ t ɒ
nə́ŋná	n ə ŋ n ɑ
ɲàd̪ùɾɔ́	ɲ ɑ d ʉ ɾ ɒ
ðávt̪ɔ́ŋðɛ́	ð ɑ v t ɒ ŋ ð ɛ
lə̀pɛ̀	l ə p ɛ
lə̀pɔ̀	l ə p ɒ
lə̀kɔ̀t̪ìnɛ̀	l ə k ɒ t i n ɛ
ðə́kɔ́t̪ínɔ́	ð ə k ɒ t i n ɒ
ðə́kɔ̀t̪ìnɔ̀	ð ə k ɒ t i n ɒ
lə̀dɔ̀ŋðìðàt̪à	l ə d ɒ ŋ ð i ð ɑ t ɑ
lə̀ǹɛ̀	l ə n ɛ
jə̀lə̀ŋà	j ə l ə ŋ ɑ
lə̀ǹà	l ə n ɑ
kájàt̪à	k ɑ j ɑ t ɑ
ájàt̪à	ɑ j ɑ t ɑ
lə̀kɔ̀t̪ìnɔ̀	l ə k ɒ t i n ɒ
ŋút̪ìnɛ̀	ŋ ʉ t i n ɛ
ðə̀m̀áɲá	ð ə m ɑ ɲ ɑ
ðáɾɔ́	ð ɑ ɾ ɒ
nìnɔ́	n i n ɒ
lə́ɾ̀làndɔ́	l ə ɾ l ɑ n d ɒ
ðə́ɾ̀làndɔ́	ð ə ɾ l ɑ n d ɒ
rùmáɲà	ɹ ʉ m ɑ ɲ ɑ
rárɛ́	ɹ ɑ ɹ ɛ
ðávt̪ɔ́ðɛ́	ð ɑ v t ɒ ð ɛ
náré	n ɑ ɹ ɛ
làɾìt̪áŋà	l ɑ ɾ i t ɑ ŋ ɑ
ɛt̪	ɛ t
kícò	k i tʃ ow
ìcɔ̀	i tʃ ɒ
lʊ̀cɔ̀	l ʊ tʃ ɒ
lícò	l i tʃ ow
lávə̀lìt̪ɔ́	l ɑ v ə l i t ɒ
ðə́və̀lɛ̀ðéɲárɛ́	ð ə v ə l ɛ ð ɛ ɲ ɑ ɹ ɛ
ðə́və̀lɛ̀ðáló	ð ə v ə l ɛ ð ɑ l ow
làɾéɲárɛ́	l ɑ ɾ ɛ ɲ ɑ ɹ ɛ
ɲáŋâ	ɲ ɑ ŋ ɑ
làɾìt̪átɛ́	l ɑ ɾ i t ɑ t ɛ
ɲáŋɛ̂	ɲ ɑ ŋ ɛ
lávə̀lìt̪ɔ̀	l ɑ v ə l i t ɒ
ŋə́ðùɽà	ŋ ə ð ʉ ɹ ɑ
jə́və̀lɛ̀ðà	j ə v ə l ɛ ð ɑ
rút̪à	ɹ ʉ t ɑ
kàŋátɛ́ŕ	k ɑ ŋ ɑ t ɛ ɹ
nɔ̀nà	n ɒ n ɑ
ðɛ̂	ð ɛ
nábòt̪ɛ̀	n ɑ b ow t ɛ
nàbòt̪ɛ̀	n ɑ b ow t ɛ
nɔ́nàŕ	n ɒ n ɑ ɹ
ágátɛ́	ɑ ɡ ɑ t ɛ
lə̀rùðɛ̀	l ə ɹ ʉ ð ɛ
kàɾà	k ɑ ɾ ɑ
ðɔ́ɽár	ð ɒ ɹ ɑ ɹ
vr̀ðìðìt̪ɔ́	v ɹ ð i ð i t ɒ
vŕðìt̪ɔ̀	v ɹ ð i t ɒ
vr̀ðìt̪ɔ́	v ɹ ð i t ɒ
àjén	ɑ j ɛ n
vr̀ðìjí	v ɹ ð i j i
vŕðìt̪ɔ̀t̪ɔ̀	v ɹ ð i t ɒ t ɒ
vr̀ðìt̪ɔ̀t̪ɔ́	v ɹ ð i t ɒ t ɒ
vŕðìðìt̪ɔ̀	v ɹ ð i ð i t ɒ
vŕðìjɔ̀	v ɹ ð i j ɒ
ðàɾɛ́ŋìðɛ́	ð ɑ ɾ ɛ ŋ i ð ɛ
jə̀və̀lɛ̀ðà	j ə v ə l ɛ ð ɑ
ðàɾìt̪ɔ̀t̪áŋàðɛ́	ð ɑ ɾ i t ɒ t ɑ ŋ ɑ ð ɛ
jáɾà	j ɑ ɾ ɑ
rúŋɔ̀ŕ	ɹ ʉ ŋ ɒ ɹ
rɔ̀ɽár	ɹ ɒ ɹ ɑ ɹ
rɔ̀rlà	ɹ ɒ ɹ l ɑ
níbí	n i b i
ŋúlá	ŋ ʉ l ɑ
ŋút̪ìjíŋ	ŋ ʉ t i j i ŋ
ŋút̪áŋà	ŋ ʉ t ɑ ŋ ɑ
ŋə̀bɔ̀lìðà	ŋ ə b ɒ l i ð ɑ
ɲúɽcà	ɲ ʉ ɹ tʃ ɑ
kìcò	k i tʃ ow
tút̪ú	t ʉ t ʉ
vɜ́ɽí	v ɐ ɹ i
t̪ɔ̀là	t ɒ l ɑ
t̪ɔ̀rlà	t ɒ ɹ l ɑ
ɜ́ɾʊ́	ɐ ɾ ʊ
jə̀ɽìɲà	j ə ɹ i ɲ ɑ
ŋə́t̪átɛ́	ŋ ə t ɑ t ɛ
ɪ̀lɛ́ð	ɪ l ɛ ð
kítàn	k i t ɑ n
ávàrú	ɑ v ɑ ɹ ʉ
lə́mùt̪ɛ̀	l ə m ʉ t ɛ
káɾóŕ	k ɑ ɾ ow ɹ
káɾá	k ɑ ɾ ɑ
ɲàlló	ɲ ɑ l l ow
ɲálló	ɲ ɑ l l ow
ɲálátɛ́	ɲ ɑ l ɑ t ɛ
álàlól	ɑ l ɑ l ow l
álátɛ́	ɑ l ɑ t ɛ
ábòt̪à	ɑ b ow t ɑ
íŋgáðə́nònnǎ	i ŋ ɡ ɑ ð ə n ow n n ɑ
káɾàŕ	k ɑ ɾ ɑ ɹ
níjì	n i j i
káŋcí	k ɑ ŋ tʃ i
ŋwút̪út̪ú	ŋ w ʉ t ʉ t ʉ
kə́ðìŋnú	k ə ð i ŋ n ʉ
jábòt̪ɛ̀	j ɑ b ow t ɛ
jábòt̪à	j ɑ b ow t ɑ
jàbòt̪ɔ́	j ɑ b ow t ɒ
lə́ŋɛ̀	l ə ŋ ɛ
kàŋcáŋá	k ɑ ŋ tʃ ɑ ŋ ɑ
kɛ̀ɾɛ̀	k ɛ ɾ ɛ
kídátɛ́ŕ	k i d ɑ t ɛ ɹ
kɛ́ɾɛ̀	k ɛ ɾ ɛ
ŋgáŋâgɛ́	ŋ ɡ ɑ ŋ ɑ ɡ ɛ
kálgɛ́	k ɑ l ɡ ɛ
jár	j ɑ ɹ
t̪ícə̀lò	t i tʃ ə l ow
àlbríð	ɑ l b ɹ i ð
kàɾt̪ìðì	k ɑ ɾ t i ð i
kìjàt̪ɔ́	k i j ɑ t ɒ
kə̀ŋàcíŋí	k ə ŋ ɑ tʃ i ŋ i
kɔ́cɔ́	k ɒ tʃ ɒ
ŋát̪àŕ	ŋ ɑ t ɑ ɹ
nɔ̀là	n ɒ l ɑ
út̪ùlá	ʉ t ʉ l ɑ
kə̀kàɾó	k ə k ɑ ɾ ow
lə́kàɾó	l ə k ɑ ɾ ow
lə́kàɾóŕ	l ə k ɑ ɾ ow ɹ
ɲákàɾó	ɲ ɑ k ɑ ɾ ow
kɛ̀gɛ́	k ɛ ɡ ɛ
kúɽcà	k ʉ ɹ tʃ ɑ
kɔ̀mɔ̀ŋnú	k ɒ m ɒ ŋ n ʉ
ɛ́jɛ̀ɲí	ɛ j ɛ ɲ i
ŕɛ̀ŕ	ɹ ɛ ɹ
jínɔ̀	j i n ɒ
ɲìjɔ́l	ɲ i j ɒ l
kə̀t̪ɛ́ŋí	k ə t ɛ ŋ i
ácám	ɑ tʃ ɑ m
kɜ́lù	k ɐ l ʉ
ápàt̪ɛ̀	ɑ p ɑ t ɛ
kɔ́ɾɛ̀	k ɒ ɾ ɛ
ɲàló	ɲ ɑ l ow
ɲàláðə́gârá	ɲ ɑ l ɑ ð ə ɡ ɑ ɹ ɑ
lùmɔ́lɛ́	l ʉ m ɒ l ɛ
lùmɛ̀ðɛ̀	l ʉ m ɛ ð ɛ
ɲàlá	ɲ ɑ l ɑ
ʃárə́nŋwɔ́	ʃ ɑ ɹ ə n ŋ w ɒ
ðájì	ð ɑ j i
lávàrà	l ɑ v ɑ ɹ ɑ
áláðə́gârár	ɑ l ɑ ð ə ɡ ɑ ɹ ɑ ɹ
áláðə́gâràr	ɑ l ɑ ð ə ɡ ɑ ɹ ɑ ɹ
kíbì	k i b i
jə́ŋàcàcí	j ə ŋ ɑ tʃ ɑ tʃ i
tútɔ́	t ʉ t ɒ
kə̀lə̀vcìðíŋì	k ə l ə v tʃ i ð i ŋ i
ŋʊ́mbòɽó	ŋ ʊ m b ow ɹ ow
ŋát̪àt̪á	ŋ ɑ t ɑ t ɑ
lɔ̀ðìðì	l ɒ ð i ð i
jìbí	j i b i
náŋìjɛ̀cì	n ɑ ŋ i j ɛ tʃ i
ɲìt̪ì	ɲ i t i
t̪ìðìjɛ̀cì	t i ð i j ɛ tʃ i
dóɾèɲà	d ow ɾ ɛ ɲ ɑ
lúmɛ̀ðɛ̀	l ʉ m ɛ ð ɛ
ákàɾó	ɑ k ɑ ɾ ow
jɛ́wàjí	j ɛ w ɑ j i
àvt̪á	ɑ v t ɑ
kájíŋì	k ɑ j i ŋ i
ɔ́ɽɔ́	ɒ ɹ ɒ
lúɽɟénɛ́	l ʉ ɹ dʒ ɛ n ɛ
ìcə̀là	i tʃ ə l ɑ
lícə̀lò	l i tʃ ə l ow
bɔ̀lá	b ɒ l ɑ
úrú	ʉ ɹ ʉ
jápìjí	j ɑ p i j i
t̪àt̪ɛ́	t ɑ t ɛ
pínɔ́	p i n ɒ
ðə́vàrà	ð ə v ɑ ɹ ɑ
ðə́várá	ð ə v ɑ ɹ ɑ
éɽò	ɛ ɹ ow
t̪ámàcíŋì	t ɑ m ɑ tʃ i ŋ i
ŋə́nìnɛ̀	ŋ ə n i n ɛ
júŋd̪ɔ̀t̪ú	j ʉ ŋ d ɒ t ʉ
jìjìðàt̪ɔ́	j i j i ð ɑ t ɒ
ðíðìnɛ̀	ð i ð i n ɛ
kə́lcì	k ə l tʃ i
àɾlàt̪á	ɑ ɾ l ɑ t ɑ
kə́ðùɽì	k ə ð ʉ ɹ i
ðúɽùbú	ð ʉ ɹ ʉ b ʉ
lə̀pìɽɜ́l	l ə p i ɹ ɐ l
ɔ̀rɛ́n	ɒ ɹ ɛ n
nɔ́ðɛ̀	n ɒ ð ɛ
kìbɔ̀	k i b ɒ
jìdìŋt̪ɔ̀t̪ú	j i d i ŋ t ɒ t ʉ
jə́ŋàwú	j ə ŋ ɑ w ʉ
làŋpú	l ɑ ŋ p ʉ
ðícə̀lò	ð i tʃ ə l ow
t̪ə̀mànú	t ə m ɑ n ʉ
ɽàɲìðìjìt̪ɔ́	ɹ ɑ ɲ i ð i j i t ɒ
nút̪à	n ʉ t ɑ
jə́nɔ̀nà	j ə n ɒ n ɑ
jɛ́nà	j ɛ n ɑ
lə́d̪ùɾáɲà	l ə d ʉ ɾ ɑ ɲ ɑ
ábót̪ɔ́	ɑ b ow t ɒ
àbòt̪á	ɑ b ow t ɑ
aɽəŋat̪ɜlo	ɑ ɹ ə ŋ ɑ t ɐ l ow
t̪áɽə̀ŋàt̪ɛ́ló	t ɑ ɹ ə ŋ ɑ t ɛ l ow
t̪àɽə̀ŋàt̪ɛ́ló	t ɑ ɹ ə ŋ ɑ t ɛ l ow
ɲáɽə̀ŋàt̪ɔ́	ɲ ɑ ɹ ə ŋ ɑ t ɒ
ŋúɽî	ŋ ʉ ɹ i
nʊ̀mí	n ʊ m i
làŋcáló	l ɑ ŋ tʃ ɑ l ow
t̪áló	t ɑ l ow
ðə̀ɾɔ́v	ð ə ɾ ɒ v
kə̀r̀ɛ̀	k ə ɹ ɛ
ìrcə̀cí	i ɹ tʃ ə tʃ i
jàɽì	j ɑ ɹ i
kìbí	k i b i
ŋə̀nɛ̀ðàt̪ɛ̀	ŋ ə n ɛ ð ɑ t ɛ
kàrɽ̀íŋí	k ɑ ɹ ɹ i ŋ i
tòsò	t ow s ow
ájínɔ́	ɑ j i n ɒ
ɜ́ɾú	ɐ ɾ ʉ
nàì	n ɑ i
ŋàt̪á	ŋ ɑ t ɑ
ŋ̀rím	ŋ ɹ i m
jɔ̀ɽár	j ɒ ɹ ɑ ɹ
óɾó	ow ɾ ow
ówà	ow w ɑ
nínɛ̀	n i n ɛ
ìrcə̀cɔ́	i ɹ tʃ ə tʃ ɒ
lácàcà	l ɑ tʃ ɑ tʃ ɑ
kə́lcàcà	k ə l tʃ ɑ tʃ ɑ
lə́ŋàt̪à	l ə ŋ ɑ t ɑ
t̪ɔ́ɽɔ́	t ɒ ɹ ɒ
t̪ɔ̀t̪á	t ɒ t ɑ
jàríbì	j ɑ ɹ i b i
làcàcí	l ɑ tʃ ɑ tʃ i
kɛ́cìt̪ɔ̀	k ɛ tʃ i t ɒ
kálɔ́ŋjú	k ɑ l ɒ ŋ j ʉ
màná	m ɑ n ɑ
ŋìðìnɔ́ŋ	ŋ i ð i n ɒ ŋ
t̪ə́r̀ɔ́t̪ɛ́	t ə ɹ ɒ t ɛ
ájít̪ɔ́	ɑ j i t ɒ
íɾdɛ́cí	i ɾ d ɛ tʃ i
ɾàcá	ɾ ɑ tʃ ɑ
áŋàt̪à	ɑ ŋ ɑ t ɑ
áɽə̀ŋàt̪ɔ́ŕ	ɑ ɹ ə ŋ ɑ t ɒ ɹ
aɽəŋajt̪i	ɑ ɹ ə ŋ ɑ j t i
aɽəŋajt̪ɜlo	ɑ ɹ ə ŋ ɑ j t ɐ l ow
íŋgáĺ	i ŋ ɡ ɑ l
áɾìðà	ɑ ɾ i ð ɑ
áɽə̀ŋàt̪àŕ	ɑ ɹ ə ŋ ɑ t ɑ ɹ
kìjàt̪à	k i j ɑ t ɑ
kɔ́dɔ́	k ɒ d ɒ
kɔ̀dɛ̀	k ɒ d ɛ
wájí	w ɑ j i
lìɾdɛ̀cì	l i ɾ d ɛ tʃ i
àwá	ɑ w ɑ
lə́t̪ì	l ə t i
t̪ɔ̂	t ɒ
láŋcìðɔ̀	l ɑ ŋ tʃ i ð ɒ
káɾðìt̪ɛ̀	k ɑ ɾ ð i t ɛ
t̪áɾɔ́t̪ɛ́	t ɑ ɾ ɒ t ɛ
lùɽìðì	l ʉ ɹ i ð i
kàŋíŋí	k ɑ ŋ i ŋ i
kápà	k ɑ p ɑ
káŋíŋì	k ɑ ŋ i ŋ i
ìt̪ìt̪ɔ́	i t i t ɒ
kápìðìt̪ɛ̀	k ɑ p i ð i t ɛ
jáŋcɛ̀cì	j ɑ ŋ tʃ ɛ tʃ i
kàŋcìjí	k ɑ ŋ tʃ i j i
káŋcìjì	k ɑ ŋ tʃ i j i
kɛ́ɾìðó	k ɛ ɾ i ð ow
mɛ̀ɾðɔ́	m ɛ ɾ ð ɒ
lɛ̀ŋcìðú	l ɛ ŋ tʃ i ð ʉ
t̪ɔ́ɽá	t ɒ ɹ ɑ
t̪àɾɔ́	t ɑ ɾ ɒ
t̪ítàn	t i t ɑ n
láŋìt̪ɛ̀	l ɑ ŋ i t ɛ
láŋìðàt̪ɛ̀	l ɑ ŋ i ð ɑ t ɛ
láŋìðàt̪à	l ɑ ŋ i ð ɑ t ɑ
t̪àɾðàt̪ɔ́	t ɑ ɾ ð ɑ t ɒ
láŋìt̪ìðì	l ɑ ŋ i t i ð i
láŋàt̪ìðà	l ɑ ŋ ɑ t i ð ɑ
lɛ́ŋcìðì	l ɛ ŋ tʃ i ð i
ŋgáĺ	ŋ ɡ ɑ l
kə̀mɛ̀ɾðɔ́gɛ́	k ə m ɛ ɾ ð ɒ ɡ ɛ
kàmɔ̀nìðɔ̀t̪ɔ́l	k ɑ m ɒ n i ð ɒ t ɒ l
láɽə̀ŋàt̪ɔ́ŋ	l ɑ ɹ ə ŋ ɑ t ɒ ŋ
rɔ́ðɔ́	ɹ ɒ ð ɒ
ŋùrú	ŋ ʉ ɹ ʉ
kàɽŋàt̪ú	k ɑ ɹ ŋ ɑ t ʉ
kàmìɲí	k ɑ m i ɲ i
ðálèŋɔ́	ð ɑ l ɛ ŋ ɒ
jáɽìŋt̪ú	j ɑ ɹ i ŋ t ʉ
áɽə̀ŋàt̪ɔ́	ɑ ɹ ə ŋ ɑ t ɒ
ɲàɽə̀ŋàt̪ɔ́	ɲ ɑ ɹ ə ŋ ɑ t ɒ
ít̪ìt̪ɔ̀	i t i t ɒ
kə̀pìt̪ìnɔ́	k ə p i t i n ɒ
kàpìðìt̪ɔ́	k ɑ p i ð i t ɒ
àɾðàt̪á	ɑ ɾ ð ɑ t ɑ
kápɛ̀	k ɑ p ɛ
káŋcìjí	k ɑ ŋ tʃ i j i
kàŋcìjìt̪ɔ́	k ɑ ŋ tʃ i j i t ɒ
kàŋcìðɔ̀t̪ɔ́	k ɑ ŋ tʃ i ð ɒ t ɒ
kə̀ŋkìðìjìt̪ú	k ə ŋ k i ð i j i t ʉ
kə̀kɛ̀cí	k ə k ɛ tʃ i
kɛ́cɛ̀cì	k ɛ tʃ ɛ tʃ i
kàpìt̪ɔ́	k ɑ p i t ɒ
káŋcìjɔ̀	k ɑ ŋ tʃ i j ɒ
kàɾcàcí	k ɑ ɾ tʃ ɑ tʃ i
káɾcàcà	k ɑ ɾ tʃ ɑ tʃ ɑ
kàpàt̪ɔ́	k ɑ p ɑ t ɒ
kápàt̪ɛ̀	k ɑ p ɑ t ɛ
kápàt̪ɔ́	k ɑ p ɑ t ɒ
kápàt̪à	k ɑ p ɑ t ɑ
kàɾðàt̪ɔ́l	k ɑ ɾ ð ɑ t ɒ l
pít̪ɛ̀	p i t ɛ
kùtìðí	k ʉ t i ð i
káɾcàcì	k ɑ ɾ tʃ ɑ tʃ i
ŋə́kɔ̀t̪ìnìjí	ŋ ə k ɒ t i n i j i
kɔ́t̪ìjì	k ɒ t i j i
káɾcìðàt̪ɛ̀	k ɑ ɾ tʃ i ð ɑ t ɛ
káɾcìðàt̪à	k ɑ ɾ tʃ i ð ɑ t ɑ
kɔ́bə̀ðɔ́	k ɒ b ə ð ɒ
ðə̀cùl	ð ə tʃ ʉ l
ðɛ́dú	ð ɛ d ʉ
kɔ́cɔ̀cɔ̀	k ɒ tʃ ɒ tʃ ɒ
ídìjì	i d i j i
ídìjɔ̀	i d i j ɒ
búlìjɛ̀cì	b ʉ l i j ɛ tʃ i
kíðìt̪ɛ̀	k i ð i t ɛ
kàɾìt̪ɛ̀	k ɑ ɾ i t ɛ
kìdɔ̀	k i d ɒ
kìdú	k i d ʉ
jɛ́ìdìjí	j ɛ i d i j i
t̪íjɔ̀	t i j ɒ
t̪ìjí	t i j i
kɛ́cìðì	k ɛ tʃ i ð i
kə̀bùlìjɛ̀cí	k ə b ʉ l i j ɛ tʃ i
kɔ̀t̪ìjí	k ɒ t i j i
kùdɛ̀cí	k ʉ d ɛ tʃ i
kùtìðɛ̀cí	k ʉ t i ð ɛ tʃ i
kə̀ðɔ́	k ə ð ɒ
ðíðì	ð i ð i
úrìjɔ̀	ʉ ɹ i j ɒ
ùrìjí	ʉ ɹ i j i
ùɽcìjí	ʉ ɹ tʃ i j i
kùɽìðìjí	k ʉ ɹ i ð i j i
ðíjì	ð i j i
úɽìðìjì	ʉ ɹ i ð i j i
túðìjì	t ʉ ð i j i
túðìjɔ̀	t ʉ ð i j ɒ
kìjìnìjí	k i j i n i j i
kájìjí	k ɑ j i j i
kùrìjí	k ʉ ɹ i j i
úrìjì	ʉ ɹ i j i
kə̀tùðìjí	k ə t ʉ ð i j i
kùtìðìjí	k ʉ t i ð i j i
kùtìðɔ̀	k ʉ t i ð ɒ
kádìjɛ̀	k ɑ d i j ɛ
ðə̀pìŋjú	ð ə p i ŋ j ʉ
kìjìjí	k i j i j i
útìðìjì	ʉ t i ð i j i
útìðìjɔ̀	ʉ t i ð i j ɒ
ùtìðìjí	ʉ t i ð i j i
kùɽcìjí	k ʉ ɹ tʃ i j i
ðɛ̂l	ð ɛ l
ŋáɾɛ̀	ŋ ɑ ɾ ɛ
ðàlèŋɔ́ŋ	ð ɑ l ɛ ŋ ɒ ŋ
ðàlèŋɔ́	ð ɑ l ɛ ŋ ɒ
ðámìɲí	ð ɑ m i ɲ i
ùɽìðìjí	ʉ ɹ i ð i j i
ðálgàrájɛ́	ð ɑ l ɡ ɑ ɹ ɑ j ɛ
jàɾɔ́jɛ́	j ɑ ɾ ɒ j ɛ
rə̀ɽà	ɹ ə ɹ ɑ
ɛ́rɜ̀lí	ɛ ɹ ɐ l i
ɛ́rɜ̀lír	ɛ ɹ ɐ l i ɹ
ìjáj	i j ɑ j
ðájá	ð ɑ j ɑ
èðɔ̀ŋ	ɛ ð ɒ ŋ
tùðìjí	t ʉ ð i j i
káɾìðó	k ɑ ɾ i ð ow
ŋə̀kàɾcí	ŋ ə k ɑ ɾ tʃ i
jáŋcìnɛ̀	j ɑ ŋ tʃ i n ɛ
jáŋcìnɔ̀	j ɑ ŋ tʃ i n ɒ
kàŋcìnìjí	k ɑ ŋ tʃ i n i j i
kámàcìt̪ɔ́	k ɑ m ɑ tʃ i t ɒ
ŋámàcì	ŋ ɑ m ɑ tʃ i
úɽcìjì	ʉ ɹ tʃ i j i
úɽcìjɔ̀	ʉ ɹ tʃ i j ɒ
íðɛ̀t̪ɛ̀	i ð ɛ t ɛ
kámàcìt̪ɛ̀	k ɑ m ɑ tʃ i t ɛ
kámàcìt̪ɔ̀	k ɑ m ɑ tʃ i t ɒ
jìcò	j i tʃ ow
mìðìjɔ́	m i ð i j ɒ
ŋə̀cíŋgɛ̀làlà	ŋ ə tʃ i ŋ ɡ ɛ l ɑ l ɑ
rùɽú	ɹ ʉ ɹ ʉ
t̪ə́mɛ̀rðɛ̀	t ə m ɛ ɹ ð ɛ
ðrávì	ð ɹ ɑ v i
kúɟí	k ʉ dʒ i
kɜ́dɛ̀cí	k ɐ d ɛ tʃ i
kɛ́cɛ́cí	k ɛ tʃ ɛ tʃ i
ámàcìt̪ɔ̀	ɑ m ɑ tʃ i t ɒ
rɜ́ɽí	ɹ ɐ ɹ i
rìcò	ɹ i tʃ ow
wáɜ́lí	w ɑ ɐ l i
jáɾìt̪ɔ́	j ɑ ɾ i t ɒ
ríjàt̪ɔ́	ɹ i j ɑ t ɒ
vàrìt̪ɔ́	v ɑ ɹ i t ɒ
t̪ɔ́ðɛ̀	t ɒ ð ɛ
ðàvt̪ɔ́ðɛ́	ð ɑ v t ɒ ð ɛ
ðɔ̀ɽà	ð ɒ ɹ ɑ
ðít̪ɔ́	ð i t ɒ
ðàɾìt̪ɔ́ðɛ́	ð ɑ ɾ i t ɒ ð ɛ
lɛ́rá	l ɛ ɹ ɑ
ŋə̀cíŋgɛ̀làlì	ŋ ə tʃ i ŋ ɡ ɛ l ɑ l i
ðə̀ǹdà	ð ə n d ɑ
kə́ɽà	k ə ɹ ɑ
làpɛ̀	l ɑ p ɛ
ŋèðìŋnú	ŋ ɛ ð i ŋ n ʉ
kùrì	k ʉ ɹ i
várá	v ɑ ɹ ɑ
ŋɔ̀dɔ̀	ŋ ɒ d ɒ
ʃárə́n	ʃ ɑ ɹ ə n
ŋgɛ̀ĺ	ŋ ɡ ɛ l
ìjɜ̀lír	i j ɐ l i ɹ
jə́ɽà	j ə ɹ ɑ
ðíɲìnɛ̀	ð i ɲ i n ɛ
t̪ìcò	t i tʃ ow
ŋə̀pìnɔ̀	ŋ ə p i n ɒ
ðàbr̀t̪ɔ́ðɛ́	ð ɑ b ɹ t ɒ ð ɛ
ɔ́ɾt̪ɔ̀	ɒ ɾ t ɒ
rít̪ɔ̀	ɹ i t ɒ
kúkùŋúðɛ́dì	k ʉ k ʉ ŋ ʉ ð ɛ d i
ídìjɔ́	i d i j ɒ
kàɾt̪ìnìjí	k ɑ ɾ t i n i j i
ðàt̪á	ð ɑ t ɑ
jɔ̀ɾt̪ɔ́	j ɒ ɾ t ɒ
ðìŋt̪úðɛ́	ð i ŋ t ʉ ð ɛ
ðàɾɔ́ðɛ́	ð ɑ ɾ ɒ ð ɛ
píɽà	p i ɹ ɑ
jàɾìt̪ɜ́llí	j ɑ ɾ i t ɐ l l i
jàvt̪ɔ́l	j ɑ v t ɒ l
kə́kɔ̀t̪ɔ́l	k ə k ɒ t ɒ l
ŋídìðìnɔ̀	ŋ i d i ð i n ɒ
kə́kɔ̀t̪ìnɔ̀	k ə k ɒ t i n ɒ
ídíðú	i d i ð ʉ
rə́t̪ìnɔ̀	ɹ ə t i n ɒ
t̪ìŕ	t i ɹ
ádìjɛ̀	ɑ d i j ɛ
láĺ	l ɑ l
àpàt̪ɔ́	ɑ p ɑ t ɒ
úrìt̪ɛ̀t̪ɛ̀	ʉ ɹ i t ɛ t ɛ
úɾɔ̀t̪ɔ̀t̪ɔ̀	ʉ ɾ ɒ t ɒ t ɒ
kárɽàt̪ɛ̀	k ɑ ɹ ɹ ɑ t ɛ
ícɔ̀	i tʃ ɒ
rə́ɽìɲàt̪ɛ̀	ɹ ə ɹ i ɲ ɑ t ɛ
nàbr̀ì	n ɑ b ɹ i
kə́kàɾì	k ə k ɑ ɾ i
ɔ́ɾɔ̀	ɒ ɾ ɒ
ɲɛ̂	ɲ ɛ
jɔ̀ɽɛ̀	j ɒ ɹ ɛ
nə̀nɔ̀nɔ́	n ə n ɒ n ɒ
rɔ̀ðɔ́	ɹ ɒ ð ɒ
ɾɔ̀ðɔ́	ɾ ɒ ð ɒ
kɔ́t̪àt̪à	k ɒ t ɑ t ɑ
ndrɛ̂ð	n d ɹ ɛ ð
lə̀dɔ̀ŋðɔ̀t̪ɔ́	l ə d ɒ ŋ ð ɒ t ɒ
rúmɔ́	ɹ ʉ m ɒ
t̪ə́nɔ̀nà	t ə n ɒ n ɑ
rə́nɔ̀nà	ɹ ə n ɒ n ɑ
lə̀kwɔ̀t̪ɔ́	l ə k w ɒ t ɒ
ŋə́kwɔ̀t̪ɔ́	ŋ ə k w ɒ t ɒ
ɲúrúl	ɲ ʉ ɹ ʉ l
ɲáɾɛ̀	ɲ ɑ ɾ ɛ
làɾɔ́lɛ́	l ɑ ɾ ɒ l ɛ
míɲá	m i ɲ ɑ
kə́dɔ̀ɽðàt̪ɔ́	k ə d ɒ ɹ ð ɑ t ɒ
lə́r̀à	l ə ɹ ɑ
jə̀və̀lɛ̀ðɔ́ŋ	j ə v ə l ɛ ð ɒ ŋ
rìjí	ɹ i j i
lácìðà	l ɑ tʃ i ð ɑ
vàrú	v ɑ ɹ ʉ
dɔ̀ŋðá	d ɒ ŋ ð ɑ
ðə̀və̀lɛ̀ðáŋá	ð ə v ə l ɛ ð ɑ ŋ ɑ
ðə̀və̀lɛ̀ðɛ̀	ð ə v ə l ɛ ð ɛ
ðàpɔ́	ð ɑ p ɒ
t̪ə̀və̀lɛ̀ðɔ́	t ə v ə l ɛ ð ɒ
lɜ̌lévə́lɛ̂ðárlô	l ɐ l ɛ v ə l ɛ ð ɑ ɹ l ow
lɜ̌lívə́lɛ̂ðárlô	l ɐ l i v ə l ɛ ð ɑ ɹ l ow
və̀lɛ̀ðɔ́ŕ	v ə l ɛ ð ɒ ɹ
ìɲárvlɛ̂ðɔ́	i ɲ ɑ ɹ v l ɛ ð ɒ
jéɲár	j ɛ ɲ ɑ ɹ
ɔ̀dɔ́	ɒ d ɒ
ɔ́mɔ́nɔ́	ɒ m ɒ n ɒ
sɔ́ɽíŋgɔ́	s ɒ ɹ i ŋ ɡ ɒ
kábr̀t̪ìnɔ̀	k ɑ b ɹ t i n ɒ
t̪ábrìt̪ìnɔ̀	t ɑ b ɹ i t i n ɒ
mɛ̀ðá	m ɛ ð ɑ
ápíðó	ɑ p i ð ow
jítàn	j i t ɑ n
àmìɲí	ɑ m i ɲ i
lǎlévə́lɛ̂ðárlô	l ɑ l ɛ v ə l ɛ ð ɑ ɹ l ow
ŋáĺ	ŋ ɑ l
láŋɛ́ló	l ɑ ŋ ɛ l ow
lɜ̌lérvə́lɛ̂ðárlô	l ɐ l ɛ ɹ v ə l ɛ ð ɑ ɹ l ow
lɜ́lívə́lɛ̂ðárlô	l ɐ l i v ə l ɛ ð ɑ ɹ l ow
vr̀ðɔ̀	v ɹ ð ɒ
ŋgǎŋə́və́lɛ̂dɔ́	ŋ ɡ ɑ ŋ ə v ə l ɛ d ɒ
ŋə́vɛ̀ðɛ̀	ŋ ə v ɛ ð ɛ
ɔ́dɔ́	ɒ d ɒ
ɔ̀dá	ɒ d ɑ
mìɲàt̪á	m i ɲ ɑ t ɑ
mìɲá	m i ɲ ɑ
ǹdá	n d ɑ
jɛ́t̪ɔ́	j ɛ t ɒ
ánìt̪ɔ́	ɑ n i t ɒ
jáŋɛ̂	j ɑ ŋ ɛ
láŋə́ĺ	l ɑ ŋ ə l
âvlɛ̀ðɛ̌ɲárɛ́	ɑ v l ɛ ð ɛ ɲ ɑ ɹ ɛ
ùdɔ́	ʉ d ɒ
jájít̪ɔ́	j ɑ j i t ɒ
jèìt̪ɔ́	j ɛ i t ɒ
làllúvə́lɛ̂ðɛ̌rlú	l ɑ l l ʉ v ə l ɛ ð ɛ ɹ l ʉ
ɲàlàtɛ́	ɲ ɑ l ɑ t ɛ
làll	l ɑ l l
làllírvə́lɛ̂ðɛ̌rlú	l ɑ l l i ɹ v ə l ɛ ð ɛ ɹ l ʉ
làllívə́lɛ̂ðɛ̌rlú	l ɑ l l i v ə l ɛ ð ɛ ɹ l ʉ
lɜ̀llívə́lɛ̂ðɛ̌rlú	l ɐ l l i v ə l ɛ ð ɛ ɹ l ʉ
ágàtɛ́	ɑ ɡ ɑ t ɛ
láŋálól	l ɑ ŋ ɑ l ow l
rúŋú	ɹ ʉ ŋ ʉ
ráĺ	ɹ ɑ l
t̪âj	t ɑ j
àɾl̀á	ɑ ɾ l ɑ
ájú	ɑ j ʉ
àjá	ɑ j ɑ
lɛ̂	l ɛ
t̪ábùðɔ́	t ɑ b ʉ ð ɒ
t̪ájàt̪à	t ɑ j ɑ t ɑ
ŋə̀pìt̪ɛ̀	ŋ ə p i t ɛ
ŋə̀pɛ̀	ŋ ə p ɛ
ɔ́ɽá	ɒ ɹ ɑ
míɲà	m i ɲ ɑ
t̪ɔ́nt̪ɔ̀	t ɒ n t ɒ
mɛ́ðàt̪ɛ̀	m ɛ ð ɑ t ɛ
íŋgàtɛ́	i ŋ ɡ ɑ t ɛ
làtɛ́	l ɑ t ɛ
ɲálàtɛ́	ɲ ɑ l ɑ t ɛ
kàŋɛ̂	k ɑ ŋ ɛ
ɲálàŋɛ̂	ɲ ɑ l ɑ ŋ ɛ
ŋúd̪ɛ̀t̪ɛ̀	ŋ ʉ d ɛ t ɛ
d̪úɾɛ̀t̪ɛ̀	d ʉ ɾ ɛ t ɛ
ŋə̀jàjɛ̀	ŋ ə j ɑ j ɛ
nídɛ̀t̪ɛ̀	n i d ɛ t ɛ
t̪ìjà	t i j ɑ
ðə́və̀lɛ̀ðɔ́ŋ	ð ə v ə l ɛ ð ɒ ŋ
jǐŋgávə́lɛ̂ðɛ̌	j i ŋ ɡ ɑ v ə l ɛ ð ɛ
ŋámàcìjìðì	ŋ ɑ m ɑ tʃ i j i ð i
jə̀kàɾàt̪à	j ə k ɑ ɾ ɑ t ɑ
lɔ́ɾìnɔ́	l ɒ ɾ i n ɒ
ńdì	n d i
ðáɾɔ́ðɛ́	ð ɑ ɾ ɒ ð ɛ
ðàl	ð ɑ l
pɛ́t̪ɛ̀	p ɛ t ɛ
jɛ́lèŋt̪ɔ́	j ɛ l ɛ ŋ t ɒ
ŋàvə̀ŋðàcàcú	ŋ ɑ v ə ŋ ð ɑ tʃ ɑ tʃ ʉ
ŋə́ðìnáló	ŋ ə ð i n ɑ l ow
káɾðáŋà	k ɑ ɾ ð ɑ ŋ ɑ
ŋálìt̪ɔ̀	ŋ ɑ l i t ɒ
ìbí	i b i
jàŋà	j ɑ ŋ ɑ
ɲàɾɔ́	ɲ ɑ ɾ ɒ
áàɾɔ́	ɑ ɑ ɾ ɒ
kávə̀lìðɜ́l	k ɑ v ə l i ð ɐ l
írdɛ̀dì	i ɹ d ɛ d i
mɛ́ðìðì	m ɛ ð i ð i
kə́və̀lɛ̀ðɔ́l	k ə v ə l ɛ ð ɒ l
t̪ə́vàt̪ɛ̀	t ə v ɑ t ɛ
t̪ə́vàrì	t ə v ɑ ɹ i
ðírɲ̀ɛ̀	ð i ɹ ɲ ɛ
ŋə́mànà	ŋ ə m ɑ n ɑ
ápìðì	ɑ p i ð i
rə́ɽàɲìðì	ɹ ə ɹ ɑ ɲ i ð i
mɛ́rðàt̪ìt̪ɛ̀	m ɛ ɹ ð ɑ t i t ɛ
jə̀r̀à	j ə ɹ ɑ
úrmùðɛ̀t̪ɛ̀	ʉ ɹ m ʉ ð ɛ t ɛ
úmìðɛ̀t̪ɛ̀	ʉ m i ð ɛ t ɛ
ɔ̀ɾt̪ɔ́	ɒ ɾ t ɒ
ílɛ̀ðìðì	i l ɛ ð i ð i
ìj	i j
ájì	ɑ j i
